ID;Municipio;SiglaEstado;QtdMasculino;QtdFeminino;QtdTotal;PercentualFeminino;PercentualMasculino
3442;NOVO TRIUNFO;BA;60;42;102;411.764.705.882.352.000;588.235.294.117.647.000
3080;MILH«;CE;73;50;123;406.504.065.040.650.000;593.495.934.959.349.000
2801;LIVRAMENTO;PB;74;50;124;403.225.806.451.612.000;596.774.193.548.387.000
4754;S«O JO«O DO POL“SINE;RS;56;37;93;397.849.462.365.591.000;602.150.537.634.408.000
136;ALTAMIRA DO MARANH«O;MA;70;46;116;396.551.724.137.931.000;603.448.275.862.068.000
3149;MONTANHAS;RN;101;65;166;391.566.265.060.240.000;608.433.734.939.759.000
60;µGUA NOVA;RN;40;25;65;384.615.384.615.384.000;615.384.615.384.615.000
4103;QUEVEDOS;RS;52;32;84;380.952.380.952.380.000;619.047.619.047.619.000
643;BOA SAÈDE;RN;77;47;124;379.032.258.064.516.000;620.967.741.935.483.000
3884;PIRES FERREIRA;CE;71;43;114;377.192.982.456.140.000;622.807.017.543.859.000
4366;SAMPAIO;TO;82;49;131;374.045.801.526.717.000;625.954.198.473.282.000
220;ANANµS;TO;69;41;110;372.727.272.727.272.000;627.272.727.272.727.000
3658;PASSAGEM FRANCA DO PIAU÷;PI;64;38;102;372.549.019.607.843.000;627.450.980.392.156.000
3067;MES‡POLIS;SP;54;32;86;372.093.023.255.813.000;627.906.976.744.186.000
2890;MALTA;PB;61;36;97;371.134.020.618.556.000;628.865.979.381.443.000
5528;VIÄOSA;RN;34;20;54;370.370.370.370.370.000;629.629.629.629.629.000
4077;PUGMIL;TO;58;34;92;369.565.217.391.304.000;630.434.782.608.695.000
565;BATALHA;PI;99;58;157;369.426.751.592.356.000;630.573.248.407.643.000
5002;SENADOR GEORGINO AVELINO;RN;69;40;109;366.972.477.064.220.000;633.027.522.935.779.000
5104;S÷TIO NOVO;RN;69;40;109;366.972.477.064.220.000;633.027.522.935.779.000
4102;QUER“NCIA DO NORTE;PR;116;67;183;366.120.218.579.234.000;633.879.781.420.765.000
3595;PARAIBANO;MA;78;45;123;365.853.658.536.585.000;634.146.341.463.414.000
5128;SUCUPIRA;TO;78;45;123;365.853.658.536.585.000;634.146.341.463.414.000
5117;SOLID«O;PE;47;27;74;364.864.864.864.864.000;635.135.135.135.135.000
1848;FORTUNA;MA;68;39;107;364.485.981.308.411.000;635.514.018.691.588.000
364;ARCO-÷RIS;SP;98;56;154;363.636.363.636.363.000;636.363.636.363.636.000
3505;OURO VELHO;PB;56;32;88;363.636.363.636.363.000;636.363.636.363.636.000
3063;MERCEDES;PR;63;36;99;363.636.363.636.363.000;636.363.636.363.636.000
1450;COXILHA;RS;62;35;97;360.824.742.268.041.000;639.175.257.731.958.000
3356;NOVA ITARANA;BA;78;44;122;360.655.737.704.918.000;639.344.262.295.081.000
1967;GRAÄA ARANHA;MA;57;32;89;359.550.561.797.752.000;640.449.438.202.247.000
3352;NOVA INDEPEND“NCIA;SP;107;60;167;359.281.437.125.748.000;640.718.562.874.251.000
3028;MATO GROSSO;PB;43;24;67;358.208.955.223.880.000;641.791.044.776.119.000
189;AMAPµ DO MARANH«O;MA;129;72;201;358.208.955.223.880.000;641.791.044.776.119.000
2438;ITAUBAL;AP;131;73;204;357.843.137.254.901.000;642.156.862.745.098.000
734;BORBOREMA;PB;79;44;123;357.723.577.235.772.000;642.276.422.764.227.000
2819;LUCRêCIA;RN;36;20;56;357.142.857.142.857.000;642.857.142.857.142.000
1321;COL‚NIA DO GURGUêIA;PI;83;46;129;356.589.147.286.821.000;643.410.852.713.178.000
3548;PALMARES PAULISTA;SP;105;58;163;355.828.220.858.895.000;644.171.779.141.104.000
4052;PRESIDENTE LUCENA;RS;58;32;90;355.555.555.555.555.000;644.444.444.444.444.000
127;ALMIRANTE TAMANDARê DO SUL;RS;60;33;93;354.838.709.677.419.000;645.161.290.322.580.000
488;BANDEIRANTES DO TOCANTINS;TO;80;44;124;354.838.709.677.419.000;645.161.290.322.580.000
2724;LAGOA SANTA;GO;51;28;79;354.430.379.746.835.000;645.569.620.253.164.000
334;ARAPOEMA;TO;115;63;178;353.932.584.269.662.000;646.067.415.730.337.000
819;BURITIZAL;SP;106;58;164;353.658.536.585.365.000;646.341.463.414.634.000
3372;NOVA OLINDA;CE;53;29;82;353.658.536.585.365.000;646.341.463.414.634.000
2730;LAGOINHA DO PIAU÷;PI;64;35;99;353.535.353.535.353.000;646.464.646.464.646.000
1323;COL‚NIA LEOPOLDINA;AL;99;54;153;352.941.176.470.588.000;647.058.823.529.411.000
5149;TABOLEIRO GRANDE;RN;44;24;68;352.941.176.470.588.000;647.058.823.529.411.000
3676;PATU;RN;68;37;105;352.380.952.380.952.000;647.619.047.619.047.000
2601;JO«O ALFREDO;PE;116;63;179;351.955.307.262.569.000;648.044.692.737.430.000
4890;S«O PEDRO DA µGUA BRANCA;MA;105;57;162;351.851.851.851.851.000;648.148.148.148.148.000
556;BARRO PRETO;BA;104;56;160;350.000.000.000.000.000;650.000.000.000.000.000
1569;DILERMANDO DE AGUIAR;RS;80;43;123;349.593.495.934.959.000;650.406.504.065.040.000
2794;LINDOESTE;PR;82;44;126;349.206.349.206.349.000;650.793.650.793.650.000
2776;LENÄ‡IS;BA;125;67;192;348.958.333.333.333.000;651.041.666.666.666.000
1929;GODOFREDO VIANA;MA;142;76;218;348.623.853.211.009.000;651.376.146.788.990.000
464;BAIXIO;CE;71;38;109;348.623.853.211.009.000;651.376.146.788.990.000
2832;LUPêRCIO;SP;114;61;175;348.571.428.571.428.000;651.428.571.428.571.000
2617;JOCA CLAUDINO;PB;43;23;66;348.484.848.484.848.000;651.515.151.515.151.000
3457;OLHO D'µGUA DO BORGES;RN;43;23;66;348.484.848.484.848.000;651.515.151.515.151.000
2263;IPUEIRA;RN;58;31;89;348.314.606.741.573.000;651.685.393.258.426.000
121;ALMADINA;BA;88;47;135;348.148.148.148.148.000;651.851.851.851.851.000
4078;PUREZA;RN;103;55;158;348.101.265.822.784.000;651.898.734.177.215.000
1600;DOM AQUINO;MT;118;63;181;348.066.298.342.541.000;651.933.701.657.458.000
5124;SOSS“GO;PB;60;32;92;347.826.086.956.521.000;652.173.913.043.478.000
4788;S«O JOSê DE MIPIBU;RN;137;73;210;347.619.047.619.047.000;652.380.952.380.952.000
1421;CORONEL XAVIER CHAVES;MG;92;49;141;347.517.730.496.453.000;652.482.269.503.546.000
3373;NOVA OLINDA;PB;47;25;72;347.222.222.222.222.000;652.777.777.777.777.000
3374;NOVA OLINDA;TO;94;50;144;347.222.222.222.222.000;652.777.777.777.777.000
3699;PAULO JACINTO;AL;111;59;170;347.058.823.529.411.000;652.941.176.470.588.000
2700;LAGOA D'ANTA;RN;64;34;98;346.938.775.510.204.000;653.061.224.489.795.000
110;ALEXANDRIA;RN;64;34;98;346.938.775.510.204.000;653.061.224.489.795.000
522;BARRA DO CHAPêU;SP;96;51;147;346.938.775.510.204.000;653.061.224.489.795.000
303;ARACI;BA;226;120;346;346.820.809.248.554.000;653.179.190.751.445.000
3715;PEDRA BRANCA DO AMAPARI;AP;130;69;199;346.733.668.341.708.000;653.266.331.658.291.000
446;AXIXµ;MA;151;80;231;346.320.346.320.346.000;653.679.653.679.653.000
5426;URBANO SANTOS;MA;153;81;234;346.153.846.153.846.000;653.846.153.846.153.000
1884;GABRIEL MONTEIRO;SP;70;37;107;345.794.392.523.364.000;654.205.607.476.635.000
663;BOCAINA DO SUL;SC;106;56;162;345.679.012.345.679.000;654.320.987.654.320.000
1497;CRUZMALTINA;PR;72;38;110;345.454.545.454.545.000;654.545.454.545.454.000
2865;MADRE DE DEUS;BA;203;107;310;345.161.290.322.580.000;654.838.709.677.419.000
1459;CRIS‡LITA;MG;114;60;174;344.827.586.206.896.000;655.172.413.793.103.000
4086;QUATIGUµ;PR;116;61;177;344.632.768.361.581.000;655.367.231.638.418.000
1664;EMAS;PB;59;31;90;344.444.444.444.444.000;655.555.555.555.555.000
4648;S«O DOMINGOS DE POMBAL;PB;40;21;61;344.262.295.081.967.000;655.737.704.918.032.000
4020;PRACUÈBA;AP;126;66;192;343.750.000.000.000.000;656.250.000.000.000.000
2405;ITAPOR« DO TOCANTINS;TO;42;22;64;343.750.000.000.000.000;656.250.000.000.000.000
4854;S«O MARCOS;RS;130;68;198;343.434.343.434.343.000;656.565.656.565.656.000
2844;MAÄAMBARµ;RS;44;23;67;343.283.582.089.552.000;656.716.417.910.447.000
4867;S«O MIGUEL DE TAIPU;PB;88;46;134;343.283.582.089.552.000;656.716.417.910.447.000
2475;IVOTI;RS;111;58;169;343.195.266.272.189.000;656.804.733.727.810.000
767;BRAZ‡POLIS;MG;178;93;271;343.173.431.734.317.000;656.826.568.265.682.000
4091;QUATRO PONTES;PR;67;35;102;343.137.254.901.960.000;656.862.745.098.039.000
5125;SOURE;PA;232;121;353;342.776.203.966.005.000;657.223.796.033.994.000
3364;NOVA MARINGµ;MT;119;62;181;342.541.436.464.088.000;657.458.563.535.911.000
3024;MATINHAS;PB;75;39;114;342.105.263.157.894.000;657.894.736.842.105.000
531;BARRA DO QUARA÷;RS;75;39;114;342.105.263.157.894.000;657.894.736.842.105.000
3285;NINA RODRIGUES;MA;77;40;117;341.880.341.880.341.000;658.119.658.119.658.000
4382;SANTA BµRBARA DO SUL;RS;77;40;117;341.880.341.880.341.000;658.119.658.119.658.000
1643;DUAS ESTRADAS;PB;52;27;79;341.772.151.898.734.000;658.227.848.101.265.000
4235;RIO DO FOGO;RN;110;57;167;341.317.365.269.461.000;658.682.634.730.538.000
1170;CASEARA;TO;116;60;176;340.909.090.909.090.000;659.090.909.090.909.000
4790;S«O JOSê DE PRINCESA;PB;58;30;88;340.909.090.909.090.000;659.090.909.090.909.000
4048;PRESIDENTE JUSCELINO;MA;153;79;232;340.517.241.379.310.000;659.482.758.620.689.000
3227;MUITOS CAPÂES;RS;62;32;94;340.425.531.914.893.000;659.574.468.085.106.000
3297;NOSSA SENHORA APARECIDA;SE;64;33;97;340.206.185.567.010.000;659.793.814.432.989.000
1551;DEPUTADO IRAPUAN PINHEIRO;CE;64;33;97;340.206.185.567.010.000;659.793.814.432.989.000
2082;HULHA NEGRA;RS;128;66;194;340.206.185.567.010.000;659.793.814.432.989.000
4977;SATUBINHA;MA;64;33;97;340.206.185.567.010.000;659.793.814.432.989.000
1351;CONCEIÄ«O DO RIO VERDE;MG;260;134;394;340.101.522.842.639.000;659.898.477.157.360.000
4188;RIBEIRA DO PIAU÷;PI;66;34;100;340.000.000.000.000.000;660.000.000.000.000.000
1335;CONCEIÄ«O DA BARRA;ES;272;140;412;339.805.825.242.718.000;660.194.174.757.281.000
5120;SONORA;MS;136;70;206;339.805.825.242.718.000;660.194.174.757.281.000
4872;S«O MIGUEL DO GOSTOSO;RN;68;35;103;339.805.825.242.718.000;660.194.174.757.281.000
1729;ESTRELA DALVA;MG;70;36;106;339.622.641.509.433.000;660.377.358.490.566.000
3085;MINADOR DO NEGR«O;AL;70;36;106;339.622.641.509.433.000;660.377.358.490.566.000
349;ARARICµ;RS;142;73;215;339.534.883.720.930.000;660.465.116.279.069.000
3563;PALMEIRAS DO TOCANTINS;TO;109;56;165;339.393.939.393.939.000;660.606.060.606.060.000
3290;N÷SIA FLORESTA;RN;146;75;221;339.366.515.837.104.000;660.633.484.162.895.000
1925;GL‡RIA DE DOURADOS;MS;154;79;233;339.055.793.991.416.000;660.944.206.008.583.000
10;ABEL FIGUEIREDO;PA;117;60;177;338.983.050.847.457.000;661.016.949.152.542.000
2882;MAJOR SALES;RN;39;20;59;338.983.050.847.457.000;661.016.949.152.542.000
3537;PALESTINA;AL;80;41;121;338.842.975.206.611.000;661.157.024.793.388.000
1372;CONQUISTA;MG;123;63;186;338.709.677.419.354.000;661.290.322.580.645.000
5400;UIRAÈNA;PB;82;42;124;338.709.677.419.354.000;661.290.322.580.645.000
2740;LAJED«O;BA;125;64;189;338.624.338.624.338.000;661.375.661.375.661.000
1727;ESTREITO;MA;211;108;319;338.557.993.730.407.000;661.442.006.269.592.000
4569;SANTO ANT‚NIO DA ALEGRIA;SP;170;87;257;338.521.400.778.210.000;661.478.599.221.789.000
755;BRASIL∂NDIA;MS;90;46;136;338.235.294.117.647.000;661.764.705.882.352.000
3964;PORT«O;RS;184;94;278;338.129.496.402.877.000;661.870.503.597.122.000
3780;PEROL∂NDIA;GO;94;48;142;338.028.169.014.084.000;661.971.830.985.915.000
2021;GUARA÷;TO;143;73;216;337.962.962.962.962.000;662.037.037.037.037.000
5155;TACIMA;PB;49;25;74;337.837.837.837.837.000;662.162.162.162.162.000
4820;S«O JOSê DO SABUGI;PB;51;26;77;337.662.337.662.337.000;662.337.662.337.662.000
5364;TUPI PAULISTA;SP;104;53;157;337.579.617.834.394.000;662.420.382.165.605.000
3400;NOVA TIMBOTEUA;PA;157;80;237;337.552.742.616.033.000;662.447.257.383.966.000
2327;ITAGUATINS;TO;106;54;160;337.500.000.000.000.000;662.500.000.000.000.000
4520;SANTA TEREZINHA DO TOCANTINS;TO;61;31;92;336.956.521.739.130.000;663.043.478.260.869.000
4796;S«O JOSê DO BONFIM;PB;63;32;95;336.842.105.263.157.000;663.157.894.736.842.000
3169;MONTE DAS GAMELEIRAS;RN;65;33;98;336.734.693.877.551.000;663.265.306.122.448.000
1267;CHAVAL;CE;65;33;98;336.734.693.877.551.000;663.265.306.122.448.000
145;ALTO ALEGRE DO MARANH«O;MA;132;67;199;336.683.417.085.427.000;663.316.582.914.572.000
3103;MIRA÷MA;CE;67;34;101;336.633.663.366.336.000;663.366.336.633.663.000
3660;PASSO DE CAMARAGIBE;AL;142;72;214;336.448.598.130.841.000;663.551.401.869.158.000
4472;SANTA MARIA DO SUAÄU÷;MG;144;73;217;336.405.529.953.917.000;663.594.470.046.082.000
474;BALNEµRIO PINHAL;RS;158;80;238;336.134.453.781.512.000;663.865.546.218.487.000
771;BREJINHO;RN;79;40;119;336.134.453.781.512.000;663.865.546.218.487.000
3428;NOVO JARDIM;TO;83;42;125;336.000.000.000.000.000;664.000.000.000.000.000
5504;VERA CRUZ;RN;83;42;125;336.000.000.000.000.000;664.000.000.000.000.000
242;ANGICAL DO PIAU÷;PI;85;43;128;335.937.500.000.000.000;664.062.500.000.000.000
4545;SANTANA DO MUNDAÈ;AL;87;44;131;335.877.862.595.419.000;664.122.137.404.580.000
159;ALTO PARA÷SO;PR;91;46;137;335.766.423.357.664.000;664.233.576.642.335.000
5389;UBAT«;BA;182;92;274;335.766.423.357.664.000;664.233.576.642.335.000
1021;CANDEIAS;BA;457;231;688;335.755.813.953.488.000;664.244.186.046.511.000
4879;S«O MIGUEL DO TOCANTINS;TO;99;50;149;335.570.469.798.657.000;664.429.530.201.342.000
404;ARUAN«;GO;107;54;161;335.403.726.708.074.000;664.596.273.291.925.000
329;ARAMINA;SP;115;58;173;335.260.115.606.936.000;664.739.884.393.063.000
5401;ULIAN‡POLIS;PA;129;65;194;335.051.546.391.752.000;664.948.453.608.247.000
2402;ITAPOµ;SC;201;101;302;334.437.086.092.715.000;665.562.913.907.284.000
2437;ITAÈBA;MT;152;76;228;333.333.333.333.333.000;666.666.666.666.666.000
2798;LINHA NOVA;RS;48;24;72;333.333.333.333.333.000;666.666.666.666.666.000
2679;JUTI;MS;64;32;96;333.333.333.333.333.000;666.666.666.666.666.000
2888;MALHADOR;SE;78;39;117;333.333.333.333.333.000;666.666.666.666.666.000
3196;MORPARµ;BA;72;36;108;333.333.333.333.333.000;666.666.666.666.666.000
3426;NOVO HORIZONTE DO SUL;MS;102;51;153;333.333.333.333.333.000;666.666.666.666.666.000
4562;SANTO AMARO DAS BROTAS;SE;214;107;321;333.333.333.333.333.000;666.666.666.666.666.000
4009;POTENGI;CE;76;38;114;333.333.333.333.333.000;666.666.666.666.666.000
4121;RAFAEL FERNANDES;RN;58;29;87;333.333.333.333.333.000;666.666.666.666.666.000
3934;PONTA DE PEDRAS;PA;194;97;291;333.333.333.333.333.000;666.666.666.666.666.000
42;AGRICOL∂NDIA;PI;58;29;87;333.333.333.333.333.000;666.666.666.666.666.000
912;CALDAS BRAND«O;PB;86;43;129;333.333.333.333.333.000;666.666.666.666.666.000
619;BERTOL÷NIA;PI;68;34;102;333.333.333.333.333.000;666.666.666.666.666.000
603;BENEDITO LEITE;MA;64;32;96;333.333.333.333.333.000;666.666.666.666.666.000
1218;CEDRAL;SP;112;56;168;333.333.333.333.333.000;666.666.666.666.666.000
1157;CARRAPATEIRA;PB;48;24;72;333.333.333.333.333.000;666.666.666.666.666.000
1193;CATAS ALTAS;MG;166;83;249;333.333.333.333.333.000;666.666.666.666.666.000
1373;CONQUISTA D'OESTE;MT;120;60;180;333.333.333.333.333.000;666.666.666.666.666.000
1390;CORDEIR‡POLIS;SP;242;121;363;333.333.333.333.333.000;666.666.666.666.666.000
1302;COCOS;BA;102;51;153;333.333.333.333.333.000;666.666.666.666.666.000
1654;ELDORADO;MS;160;80;240;333.333.333.333.333.000;666.666.666.666.666.000
1676;ENGENHEIRO CALDAS;MG;94;47;141;333.333.333.333.333.000;666.666.666.666.666.000
1736;ESTRELA VELHA;RS;58;29;87;333.333.333.333.333.000;666.666.666.666.666.000
5232;TENENTE ANANIAS;RN;70;35;105;333.333.333.333.333.000;666.666.666.666.666.000
5265;TIET“;SP;278;139;417;333.333.333.333.333.000;666.666.666.666.666.000
5486;VµRZEA DO POÄO;BA;76;38;114;333.333.333.333.333.000;666.666.666.666.666.000
4861;S«O MIGUEL;RN;86;43;129;333.333.333.333.333.000;666.666.666.666.666.000
4650;S«O DOMINGOS DO AZEIT«O;MA;80;40;120;333.333.333.333.333.000;666.666.666.666.666.000
4729;S«O JO«O DA VARJOTA;PI;46;23;69;333.333.333.333.333.000;666.666.666.666.666.000
5053;SERRAN‡POLIS DO IGUAÄU;PR;68;34;102;333.333.333.333.333.000;666.666.666.666.666.000
2272;IRACEMµPOLIS;SP;231;115;346;332.369.942.196.531.000;667.630.057.803.468.000
1284;CIDREIRA;RS;201;100;301;332.225.913.621.262.000;667.774.086.378.737.000
3937;PONTAL;SP;318;158;476;331.932.773.109.243.000;668.067.226.890.756.000
3151;MONTE ALEGRE;RN;125;62;187;331.550.802.139.037.000;668.449.197.860.962.000
2611;JO«O RAMALHO;SP;125;62;187;331.550.802.139.037.000;668.449.197.860.962.000
1251;CHµCARA;MG;121;60;181;331.491.712.707.182.000;668.508.287.292.817.000
5072;SETE QUEDAS;MS;119;59;178;331.460.674.157.303.000;668.539.325.842.696.000
1921;GIRUµ;RS;109;54;163;331.288.343.558.282.000;668.711.656.441.717.000
2875;MAIQUINIQUE;BA;109;54;163;331.288.343.558.282.000;668.711.656.441.717.000
1160;CARUTAPERA;MA;99;49;148;331.081.081.081.081.000;668.918.918.918.918.000
4490;SANTA RITA DO PARDO;MS;97;48;145;331.034.482.758.620.000;668.965.517.241.379.000
4424;SANTA FILOMENA;PE;95;47;142;330.985.915.492.957.000;669.014.084.507.042.000
1038;CANHOBA;SE;93;46;139;330.935.251.798.561.000;669.064.748.201.438.000
1478;CROATµ;CE;89;44;133;330.827.067.669.172.000;669.172.932.330.827.000
5406;UMBURATIBA;MG;87;43;130;330.769.230.769.230.000;669.230.769.230.769.000
3309;NOVA ALVORADA DO SUL;MS;170;84;254;330.708.661.417.322.000;669.291.338.582.677.000
3244;MURICI DOS PORTELAS;PI;83;41;124;330.645.161.290.322.000;669.354.838.709.677.000
1046;CANTµ;RR;247;122;369;330.623.306.233.062.000;669.376.693.766.937.000
5314;TR“S BARRAS;SC;243;120;363;330.578.512.396.694.000;669.421.487.603.305.000
301;ARACATU;BA;75;37;112;330.357.142.857.142.000;669.642.857.142.857.000
520;BARRA DE S«O MIGUEL;AL;144;71;215;330.232.558.139.534.000;669.767.441.860.465.000
1089;CAPIVARI DO SUL;RS;71;35;106;330.188.679.245.283.000;669.811.320.754.716.000
1726;ESTIVA GERBI;SP;213;105;318;330.188.679.245.283.000;669.811.320.754.716.000
2886;MALHADA DE PEDRAS;BA;71;35;106;330.188.679.245.283.000;669.811.320.754.716.000
2570;JATOBµ;MA;69;34;103;330.097.087.378.640.000;669.902.912.621.359.000
2289;IRINE‡POLIS;SC;138;68;206;330.097.087.378.640.000;669.902.912.621.359.000
856;CACHOEIRA DOURADA;GO;136;67;203;330.049.261.083.743.000;669.950.738.916.256.000
3213;MORTUGABA;BA;67;33;100;330.000.000.000.000.000;670.000.000.000.000.000
425;ATIBAIA;SP;522;257;779;329.910.141.206.675.000;670.089.858.793.324.000
2236;IPAUMIRIM;CE;65;32;97;329.896.907.216.494.000;670.103.092.783.505.000
3127;MOGEIRO;PB;130;64;194;329.896.907.216.494.000;670.103.092.783.505.000
5430;URUANA DE MINAS;MG;130;64;194;329.896.907.216.494.000;670.103.092.783.505.000
431;µUREA;RS;63;31;94;329.787.234.042.553.000;670.212.765.957.446.000
4792;S«O JOSê DE UBµ;RJ;187;92;279;329.749.103.942.652.000;670.250.896.057.347.000
500;BARAÈNA;RN;185;91;276;329.710.144.927.536.000;670.289.855.072.463.000
3958;PORANGA;CE;61;30;91;329.670.329.670.329.000;670.329.670.329.670.000
111;ALEX∂NIA;GO;283;139;422;329.383.886.255.924.000;670.616.113.744.075.000
1526;CURRALINHO;PA;283;139;422;329.383.886.255.924.000;670.616.113.744.075.000
1907;GAVI«O PEIXOTO;SP;167;82;249;329.317.269.076.305.000;670.682.730.923.694.000
4320;RUR‡POLIS;PA;222;109;331;329.305.135.951.661.000;670.694.864.048.338.000
5111;SOCORRO;SP;165;81;246;329.268.292.682.926.000;670.731.707.317.073.000
579;BELA VISTA DO MARANH«O;MA;108;53;161;329.192.546.583.850.000;670.807.453.416.149.000
4266;RIO PRETO DA EVA;AM;261;128;389;329.048.843.187.660.000;670.951.156.812.339.000
4421;SANTA Fê DO ARAGUAIA;TO;102;50;152;328.947.368.421.052.000;671.052.631.578.947.000
5151;TABULEIRO DO NORTE;CE;102;50;152;328.947.368.421.052.000;671.052.631.578.947.000
327;ARAMBARê;RS;100;49;149;328.859.060.402.684.000;671.140.939.597.315.000
5559;VIRMOND;PR;100;49;149;328.859.060.402.684.000;671.140.939.597.315.000
4221;RIO BRILHANTE;MS;198;97;295;328.813.559.322.033.000;671.186.440.677.966.000
1363;CONDOR;RS;49;24;73;328.767.123.287.671.000;671.232.876.712.328.000
4735;S«O JO«O DE PIRABAS;PA;284;139;423;328.605.200.945.626.000;671.394.799.054.373.000
1516;CURION‡POLIS;PA;188;92;280;328.571.428.571.428.000;671.428.571.428.571.000
3104;MIRANDA;MS;233;114;347;328.530.259.365.994.000;671.469.740.634.005.000
1568;DIAS D'µVILA;BA;323;158;481;328.482.328.482.328.000;671.517.671.517.671.000
3742;PEDRO DO ROSµRIO;MA;184;90;274;328.467.153.284.671.000;671.532.846.715.328.000
5425;UR∂NIA;SP;137;67;204;328.431.372.549.019.000;671.568.627.450.980.000
1781;FELIZ NATAL;MT;90;44;134;328.358.208.955.223.000;671.641.791.044.776.000
4092;QUEBRANGULO;AL;133;65;198;328.282.828.282.828.000;671.717.171.717.171.000
3047;MAURIL∂NDIA;GO;131;64;195;328.205.128.205.128.000;671.794.871.794.871.000
1330;COMENDADOR LEVY GASPARIAN;RJ;217;106;323;328.173.374.613.003.000;671.826.625.386.996.000
3844;PINTO BANDEIRA;RS;43;21;64;328.125.000.000.000.000;671.875.000.000.000.000
3850;PIQUETE;SP;336;164;500;328.000.000.000.000.000;672.000.000.000.000.000
92;ALAGOINHA;PB;84;41;125;328.000.000.000.000.000;672.000.000.000.000.000
5220;TAVARES;PB;84;41;125;328.000.000.000.000.000;672.000.000.000.000.000
3790;PIAÄABUÄU;AL;123;60;183;327.868.852.459.016.000;672.131.147.540.983.000
3907;PLANALTO DA SERRA;MT;82;40;122;327.868.852.459.016.000;672.131.147.540.983.000
3361;NOVA LUZIT∂NIA;SP;123;60;183;327.868.852.459.016.000;672.131.147.540.983.000
2757;LARANJAL DO JARI;AP;287;140;427;327.868.852.459.016.000;672.131.147.540.983.000
4957;S«O VICENTE FERRER;MA;164;80;244;327.868.852.459.016.000;672.131.147.540.983.000
337;ARAPOR«;MG;162;79;241;327.800.829.875.518.000;672.199.170.124.481.000
1847;FORTIM;CE;80;39;119;327.731.092.436.974.000;672.268.907.563.025.000
2708;LAGOA DO MATO;MA;80;39;119;327.731.092.436.974.000;672.268.907.563.025.000
2891;MAMANGUAPE;PB;199;97;296;327.702.702.702.702.000;672.297.297.297.297.000
4199;RIBEIR«O DO SUL;SP;156;76;232;327.586.206.896.551.000;672.413.793.103.448.000
791;BROTAS DE MACAÈBAS;BA;78;38;116;327.586.206.896.551.000;672.413.793.103.448.000
5102;S÷TIO DO QUINTO;BA;78;38;116;327.586.206.896.551.000;672.413.793.103.448.000
823;CAAPOR«;PB;193;94;287;327.526.132.404.181.000;672.473.867.595.818.000
3997;PORTO REAL DO COLêGIO;AL;115;56;171;327.485.380.116.959.000;672.514.619.883.040.000
4599;SANTO ANT‚NIO DO TAUµ;PA;382;186;568;327.464.788.732.394.000;672.535.211.267.605.000
4881;S«O MIGUEL DOS MILAGRES;AL;191;93;284;327.464.788.732.394.000;672.535.211.267.605.000
4369;SANDOL∂NDIA;TO;76;37;113;327.433.628.318.584.000;672.566.371.681.415.000
790;BROTAS;SP;224;109;333;327.327.327.327.327.000;672.672.672.672.672.000
4207;RIBEIR‡POLIS;SE;111;54;165;327.272.727.272.727.000;672.727.272.727.272.000
2643;JUCURUTU;RN;74;36;110;327.272.727.272.727.000;672.727.272.727.272.000
2667;JURU;PB;74;36;110;327.272.727.272.727.000;672.727.272.727.272.000
2585;JEREMOABO;BA;111;54;165;327.272.727.272.727.000;672.727.272.727.272.000
4458;SANTA MARGARIDA DO SUL;RS;72;35;107;327.102.803.738.317.000;672.897.196.261.682.000
3991;PORTO GRANDE;AP;216;105;321;327.102.803.738.317.000;672.897.196.261.682.000
4909;S«O RAIMUNDO DO DOCA BEZERRA;MA;72;35;107;327.102.803.738.317.000;672.897.196.261.682.000
5369;TURIÈBA;SP;72;35;107;327.102.803.738.317.000;672.897.196.261.682.000
2837;LUZI∂NIA;GO;527;256;783;326.947.637.292.464.000;673.052.362.707.535.000
1115;CARDOSO;SP;140;68;208;326.923.076.923.076.000;673.076.923.076.923.000
2209;INDIAN‡POLIS;PR;105;51;156;326.923.076.923.076.000;673.076.923.076.923.000
5182;TANQUINHO;BA;140;68;208;326.923.076.923.076.000;673.076.923.076.923.000
5130;SUCUPIRA DO RIACH«O;MA;70;34;104;326.923.076.923.076.000;673.076.923.076.923.000
2183;ILHABELA;SP;338;164;502;326.693.227.091.633.000;673.306.772.908.366.000
3215;MOSS∂MEDES;GO;66;32;98;326.530.612.244.897.000;673.469.387.755.102.000
4085;QUATµ;SP;132;64;196;326.530.612.244.897.000;673.469.387.755.102.000
2928;MARACAÄUMê;MA;229;111;340;326.470.588.235.294.000;673.529.411.764.705.000
1003;CAMPOS NOVOS PAULISTA;SP;130;63;193;326.424.870.466.321.000;673.575.129.533.678.000
3302;NOSSA SENHORA DE NAZARê;PI;64;31;95;326.315.789.473.684.000;673.684.210.526.315.000
5481;VµRZEA;PB;64;31;95;326.315.789.473.684.000;673.684.210.526.315.000
2759;LARANJEIRAS;SE;159;77;236;326.271.186.440.677.000;673.728.813.559.322.000
3243;MURICI;AL;95;46;141;326.241.134.751.773.000;673.758.865.248.226.000
400;ARROIO DOS RATOS;RS;126;61;187;326.203.208.556.149.000;673.796.791.443.850.000
3641;PARIQUERA-AÄU;SP;219;106;325;326.153.846.153.846.000;673.846.153.846.153.000
3895;PIÈMA;ES;281;136;417;326.139.088.729.016.000;673.860.911.270.983.000
3395;NOVA SANTA RITA;PI;62;30;92;326.086.956.521.739.000;673.913.043.478.260.000
4671;S«O FRANCISCO;SE;62;30;92;326.086.956.521.739.000;673.913.043.478.260.000
4403;SANTA CRUZ DAS PALMEIRAS;SP;246;119;365;326.027.397.260.273.000;673.972.602.739.726.000
1389;CORDEIRO;RJ;211;102;313;325.878.594.249.201.000;674.121.405.750.798.000
4951;S«O VICENTE;RN;60;29;89;325.842.696.629.213.000;674.157.303.370.786.000
4453;SANTA LUZIA DO NORTE;AL;147;71;218;325.688.073.394.495.000;674.311.926.605.504.000
2952;MARCEL∂NDIA;MT;147;71;218;325.688.073.394.495.000;674.311.926.605.504.000
3465;OLINDA NOVA DO MARANH«O;MA;174;84;258;325.581.395.348.837.000;674.418.604.651.162.000
4723;S«O JO«O DA MATA;MG;58;28;86;325.581.395.348.837.000;674.418.604.651.162.000
3354;NOVA IPIXUNA;PA;172;83;255;325.490.196.078.431.000;674.509.803.921.568.000
1135;CARMO;RJ;228;110;338;325.443.786.982.248.000;674.556.213.017.751.000
1099;CARA÷BAS;BA;112;54;166;325.301.204.819.277.000;674.698.795.180.722.000
2490;JACAREZINHO;PR;251;121;372;325.268.817.204.301.000;674.731.182.795.698.000
3436;NOVO PROGRESSO;PA;195;94;289;325.259.515.570.934.000;674.740.484.429.065.000
2412;ITAPU÷;SP;222;107;329;325.227.963.525.835.000;674.772.036.474.164.000
907;CAJURI;MG;83;40;123;325.203.252.032.520.000;674.796.747.967.479.000
3628;PARATY;RJ;247;119;366;325.136.612.021.857.000;674.863.387.978.142.000
4436;SANTA IN“S;BA;137;66;203;325.123.152.709.359.000;674.876.847.290.640.000
4745;S«O JO«O DO MANHUAÄU;MG;164;79;243;325.102.880.658.436.000;674.897.119.341.563.000
3932;POMPêU;MG;191;92;283;325.088.339.222.614.000;674.911.660.777.385.000
2607;JO«O MONLEVADE;MG;326;157;483;325.051.759.834.368.000;674.948.240.165.631.000
3807;PILAR;PB;135;65;200;325.000.000.000.000.000;675.000.000.000.000.000
887;CAIBATê;RS;54;26;80;325.000.000.000.000.000;675.000.000.000.000.000
2265;IPUEIRAS;TO;81;39;120;325.000.000.000.000.000;675.000.000.000.000.000
5250;TERRA DE AREIA;RS;81;39;120;325.000.000.000.000.000;675.000.000.000.000.000
5423;URA÷;PR;187;90;277;324.909.747.292.418.000;675.090.252.707.581.000
1561;DIAMANTE;PB;79;38;117;324.786.324.786.324.000;675.213.675.213.675.000
836;CABRµLIA PAULISTA;SP;158;76;234;324.786.324.786.324.000;675.213.675.213.675.000
605;BENEVIDES;PA;316;152;468;324.786.324.786.324.000;675.213.675.213.675.000
451;BACURI;MA;158;76;234;324.786.324.786.324.000;675.213.675.213.675.000
265;ANT‚NIO GONÄALVES;BA;79;38;117;324.786.324.786.324.000;675.213.675.213.675.000
1262;CHAPADINHA;MA;262;126;388;324.742.268.041.237.000;675.257.731.958.762.000
4172;RIACHO DA CRUZ;RN;52;25;77;324.675.324.675.324.000;675.324.675.324.675.000
4964;SAPUCAIA;PA;156;75;231;324.675.324.675.324.000;675.324.675.324.675.000
18;ACARµ;PA;414;199;613;324.632.952.691.680.000;675.367.047.308.319.000
5121;SOORETAMA;ES;206;99;305;324.590.163.934.426.000;675.409.836.065.573.000
4166;RIACH«O DO BACAMARTE;PB;77;37;114;324.561.403.508.771.000;675.438.596.491.228.000
2710;LAGOA DO PIAU÷;PI;77;37;114;324.561.403.508.771.000;675.438.596.491.228.000
2676;JUSSARI;BA;102;49;151;324.503.311.258.278.000;675.496.688.741.721.000
2590;JESU∂NIA;MG;127;61;188;324.468.085.106.382.000;675.531.914.893.617.000
2657;JUNQUEIR‡POLIS;SP;125;60;185;324.324.324.324.324.000;675.675.675.675.675.000
3075;MIGUEL PEREIRA;RJ;375;180;555;324.324.324.324.324.000;675.675.675.675.675.000
3480;ORIZONA;GO;100;48;148;324.324.324.324.324.000;675.675.675.675.675.000
3873;PIRAPORA DO BOM JESUS;SP;348;167;515;324.271.844.660.194.000;675.728.155.339.805.000
2447;ITIRAPINA;SP;271;130;401;324.189.526.184.538.000;675.810.473.815.461.000
1876;FRONTEIRA;MG;196;94;290;324.137.931.034.482.000;675.862.068.965.517.000
4718;S«O JO«O DA BARRA;RJ;294;141;435;324.137.931.034.482.000;675.862.068.965.517.000
218;ANAL∂NDIA;SP;171;82;253;324.110.671.936.758.000;675.889.328.063.241.000
3975;PORTO ALEGRE DO TOCANTINS;TO;73;35;108;324.074.074.074.074.000;675.925.925.925.925.000
946;CAMPESTRE DE GOIµS;GO;121;58;179;324.022.346.368.715.000;675.977.653.631.284.000
1984;GRUPIARA;MG;48;23;71;323.943.661.971.830.000;676.056.338.028.169.000
1742;EUSêBIO;CE;192;92;284;323.943.661.971.830.000;676.056.338.028.169.000
5058;SERRINHA DOS PINTOS;RN;48;23;71;323.943.661.971.830.000;676.056.338.028.169.000
32;ADOLFO;SP;119;57;176;323.863.636.363.636.000;676.136.363.636.363.000
3038;MATOZINHOS;MG;357;171;528;323.863.636.363.636.000;676.136.363.636.363.000
5312;TREMEMBê;SP;309;148;457;323.851.203.501.094.000;676.148.796.498.905.000
5478;VARJOTA;CE;71;34;105;323.809.523.809.523.000;676.190.476.190.476.000
974;CAMPO DO TENENTE;PR;165;79;244;323.770.491.803.278.000;676.229.508.196.721.000
166;ALTO RIO NOVO;ES;94;45;139;323.741.007.194.244.000;676.258.992.805.755.000
1624;DORES DO RIO PRETO;ES;94;45;139;323.741.007.194.244.000;676.258.992.805.755.000
3869;PIRAPEMAS;MA;209;100;309;323.624.595.469.255.000;676.375.404.530.744.000
4471;SANTA MARIA DO SALTO;MG;69;33;102;323.529.411.764.705.000;676.470.588.235.294.000
1657;ELDORADO DOS CARAJµS;PA;207;99;306;323.529.411.764.705.000;676.470.588.235.294.000
3476;ORIENTE;SP;182;87;269;323.420.074.349.442.000;676.579.925.650.557.000
239;ANGELIM;PE;90;43;133;323.308.270.676.691.000;676.691.729.323.308.000
4485;SANTA RITA DE JACUTINGA;MG;88;42;130;323.076.923.076.923.000;676.923.076.923.076.000
632;BIRITIBA MIRIM;SP;413;197;610;322.950.819.672.131.000;677.049.180.327.868.000
4491;SANTA RITA DO PASSA QUATRO;SP;239;114;353;322.946.175.637.393.000;677.053.824.362.606.000
3996;PORTO REAL;RJ;304;145;449;322.939.866.369.710.000;677.060.133.630.289.000
4261;RIO PARDO;RS;235;112;347;322.766.570.605.187.000;677.233.429.394.812.000
2381;ITAPEMA;SC;277;132;409;322.738.386.308.068.000;677.261.613.691.931.000
312;ARAGOI∂NIA;GO;149;71;220;322.727.272.727.272.000;677.272.727.272.727.000
3987;PORTO FELIZ;SP;359;171;530;322.641.509.433.962.000;677.358.490.566.037.000
3518;PACATUBA;SE;147;70;217;322.580.645.161.290.000;677.419.354.838.709.000
3525;PADRE MARCOS;PI;63;30;93;322.580.645.161.290.000;677.419.354.838.709.000
4137;RECURSOL∂NDIA;TO;63;30;93;322.580.645.161.290.000;677.419.354.838.709.000
4419;SANTA Fê DE GOIµS;GO;84;40;124;322.580.645.161.290.000;677.419.354.838.709.000
2675;JUSSARA;BA;105;50;155;322.580.645.161.290.000;677.419.354.838.709.000
5110;SOBRµLIA;MG;166;79;245;322.448.979.591.836.000;677.551.020.408.163.000
1416;CORONEL MURTA;MG;124;59;183;322.404.371.584.699.000;677.595.628.415.300.000
2279;IRANI;SC;103;49;152;322.368.421.052.631.000;677.631.578.947.368.000
1312;COLINA;SP;185;88;273;322.344.322.344.322.000;677.655.677.655.677.000
5233;TENENTE LAURENTINO CRUZ;RN;82;39;121;322.314.049.586.776.000;677.685.950.413.223.000
2851;MACAUBAL;SP;122;58;180;322.222.222.222.222.000;677.777.777.777.777.000
4828;S«O JOSê DOS CORDEIROS;PB;61;29;90;322.222.222.222.222.000;677.777.777.777.777.000
1300;COCALINHO;MT;101;48;149;322.147.651.006.711.000;677.852.348.993.288.000
4899;S«O PEDRO DO IVA÷;PR;141;67;208;322.115.384.615.384.000;677.884.615.384.615.000
2911;MANHUMIRIM;MG;221;105;326;322.085.889.570.552.000;677.914.110.429.447.000
3082;MIMOSO DE GOIµS;GO;120;57;177;322.033.898.305.084.000;677.966.101.694.915.000
2542;JAPOR«;MS;200;95;295;322.033.898.305.084.000;677.966.101.694.915.000
2086;IACANGA;SP;120;57;177;322.033.898.305.084.000;677.966.101.694.915.000
511;BARRA BONITA;SP;398;189;587;321.976.149.914.821.000;678.023.850.085.178.000
3210;MORRO REDONDO;RS;99;47;146;321.917.808.219.178.000;678.082.191.780.821.000
236;ANGATUBA;SP;257;122;379;321.899.736.147.757.000;678.100.263.852.242.000
1824;FL‡RIDA;PR;59;28;87;321.839.080.459.770.000;678.160.919.540.229.000
2989;MARLIêRIA;MG;137;65;202;321.782.178.217.821.000;678.217.821.782.178.000
81;AGUIARN‡POLIS;TO;78;37;115;321.739.130.434.782.000;678.260.869.565.217.000
837;CABREÈVA;SP;270;128;398;321.608.040.201.005.000;678.391.959.798.994.000
2748;LAMBARI;MG;249;118;367;321.525.885.558.583.000;678.474.114.441.416.000
4411;SANTA CRUZ DO PIAU÷;PI;57;27;84;321.428.571.428.571.000;678.571.428.571.428.000
3821;PINDOBA;AL;57;27;84;321.428.571.428.571.000;678.571.428.571.428.000
3623;PARAOPEBA;MG;319;151;470;321.276.595.744.680.000;678.723.404.255.319.000
2444;ITINGA;MG;150;71;221;321.266.968.325.791.000;678.733.031.674.208.000
1277;CHUPINGUAIA;RO;131;62;193;321.243.523.316.062.000;678.756.476.683.937.000
811;BURITI DOS LOPES;PI;112;53;165;321.212.121.212.121.000;678.787.878.787.878.000
481;BANANAL;SP;224;106;330;321.212.121.212.121.000;678.787.878.787.878.000
2070;HERVAL;RS;93;44;137;321.167.883.211.678.000;678.832.116.788.321.000
3090;MINEIROS;GO;222;105;327;321.100.917.431.192.000;678.899.082.568.807.000
4989;SEBERI;RS;74;35;109;321.100.917.431.192.000;678.899.082.568.807.000
4602;SANTO AUGUSTO;RS;74;35;109;321.100.917.431.192.000;678.899.082.568.807.000
3091;MINEIROS DO TIET“;SP;203;96;299;321.070.234.113.712.000;678.929.765.886.287.000
4395;SANTA CRUZ;RN;129;61;190;321.052.631.578.947.000;678.947.368.421.052.000
1995;GUAIRAÄµ;PR;110;52;162;320.987.654.320.987.000;679.012.345.679.012.000
627;BICAS;MG;220;104;324;320.987.654.320.987.000;679.012.345.679.012.000
661;BOCAINA;PI;55;26;81;320.987.654.320.987.000;679.012.345.679.012.000
452;BACURITUBA;MA;146;69;215;320.930.232.558.139.000;679.069.767.441.860.000
1436;CORUMBATA÷ DO SUL;PR;146;69;215;320.930.232.558.139.000;679.069.767.441.860.000
3615;PARANA÷TA;MT;91;43;134;320.895.522.388.059.000;679.104.477.611.940.000
4425;SANTA FILOMENA DO MARANH«O;MA;72;34;106;320.754.716.981.132.000;679.245.283.018.867.000
1718;ESP÷RITO SANTO DO TURVO;SP;108;51;159;320.754.716.981.132.000;679.245.283.018.867.000
2408;ITAPORANGA D'AJUDA;SE;233;110;343;320.699.708.454.810.000;679.300.291.545.189.000
307;ARAÄOIABA DA SERRA;SP;250;118;368;320.652.173.913.043.000;679.347.826.086.956.000
4209;RINC«O;SP;195;92;287;320.557.491.289.198.000;679.442.508.710.801.000
5070;SETE DE SETEMBRO;RS;53;25;78;320.512.820.512.820.000;679.487.179.487.179.000
2231;IPAMERI;GO;229;108;337;320.474.777.448.071.000;679.525.222.551.928.000
3323;NOVA CAMPINA;SP;176;83;259;320.463.320.463.320.000;679.536.679.536.679.000
2652;JUNDIµ;RN;70;33;103;320.388.349.514.563.000;679.611.650.485.436.000
4041;PRESIDENTE DUTRA;MA;140;66;206;320.388.349.514.563.000;679.611.650.485.436.000
980;CAMPO GRANDE;AL;70;33;103;320.388.349.514.563.000;679.611.650.485.436.000
5068;SERT«OZINHO;PB;70;33;103;320.388.349.514.563.000;679.611.650.485.436.000
372;AREIA BRANCA;SE;227;107;334;320.359.281.437.125.000;679.640.718.562.874.000
1173;CASINHAS;PE;104;49;153;320.261.437.908.496.000;679.738.562.091.503.000
505;BARCARENA;PA;450;212;662;320.241.691.842.900.000;679.758.308.157.099.000
3643;PARNAGUµ;PI;68;32;100;320.000.000.000.000.000;680.000.000.000.000.000
2471;IVATUBA;PR;68;32;100;320.000.000.000.000.000;680.000.000.000.000.000
2887;MALHADA DOS BOIS;SE;68;32;100;320.000.000.000.000.000;680.000.000.000.000.000
5463;VANINI;RS;51;24;75;320.000.000.000.000.000;680.000.000.000.000.000
2823;LU÷S DOMINGUES;MA;117;55;172;319.767.441.860.465.000;680.232.558.139.534.000
842;CACAUL∂NDIA;RO;117;55;172;319.767.441.860.465.000;680.232.558.139.534.000
4570;SANTO ANT‚NIO DA BARRA;GO;117;55;172;319.767.441.860.465.000;680.232.558.139.534.000
2809;LONTRAS;SC;100;47;147;319.727.891.156.462.000;680.272.108.843.537.000
3945;PONTE ALTA DO NORTE;SC;100;47;147;319.727.891.156.462.000;680.272.108.843.537.000
3888;PIRPIRITUBA;PB;100;47;147;319.727.891.156.462.000;680.272.108.843.537.000
2961;MARECHAL FLORIANO;ES;183;86;269;319.702.602.230.483.000;680.297.397.769.516.000
2562;JARINU;SP;315;148;463;319.654.427.645.788.000;680.345.572.354.211.000
3369;NOVA ODESSA;SP;298;140;438;319.634.703.196.347.000;680.365.296.803.652.000
4062;PRIMAVERA;PA;132;62;194;319.587.628.865.979.000;680.412.371.134.020.000
4429;SANTA HELENA;PB;66;31;97;319.587.628.865.979.000;680.412.371.134.020.000
427;AUGUSTIN‡POLIS;TO;147;69;216;319.444.444.444.444.000;680.555.555.555.555.000
1291;CLµUDIO;MG;245;115;360;319.444.444.444.444.000;680.555.555.555.555.000
1548;DEMERVAL LOB«O;PI;147;69;216;319.444.444.444.444.000;680.555.555.555.555.000
1934;GOIANµPOLIS;GO;196;92;288;319.444.444.444.444.000;680.555.555.555.555.000
4590;SANTO ANT‚NIO DO LEVERGER;MT;179;84;263;319.391.634.980.988.000;680.608.365.019.011.000
2097;IBATEGUARA;AL;130;61;191;319.371.727.748.691.000;680.628.272.251.308.000
4779;S«O JOSê DA LAPA;MG;260;122;382;319.371.727.748.691.000;680.628.272.251.308.000
773;BREJO;MA;211;99;310;319.354.838.709.677.000;680.645.161.290.322.000
2029;GUARANI D'OESTE;SP;81;38;119;319.327.731.092.436.000;680.672.268.907.563.000
4027;PRAIA NORTE;TO;81;38;119;319.327.731.092.436.000;680.672.268.907.563.000
4385;SANTA BRANCA;SP;307;144;451;319.290.465.631.929.000;680.709.534.368.070.000
1023;CANDEIAS DO JAMARI;RO;354;166;520;319.230.769.230.769.000;680.769.230.769.230.000
4703;S«O GONÄALO DO PARµ;MG;177;83;260;319.230.769.230.769.000;680.769.230.769.230.000
1222;CEDRO DO ABAETê;MG;64;30;94;319.148.936.170.212.000;680.851.063.829.787.000
5590;WESTFµLIA;RS;32;15;47;319.148.936.170.212.000;680.851.063.829.787.000
4257;RIO NEGRO;PR;239;112;351;319.088.319.088.319.000;680.911.680.911.680.000
917;CALIF‡RNIA;PR;175;82;257;319.066.147.859.922.000;680.933.852.140.077.000
1656;ELDORADO DO SUL;RS;254;119;373;319.034.852.546.916.000;680.965.147.453.083.000
2931;MARACAJU;MS;222;104;326;319.018.404.907.975.000;680.981.595.092.024.000
1627;DORMENTES;PE;79;37;116;318.965.517.241.379.000;681.034.482.758.620.000
1830;FORMIGUEIRO;RS;79;37;116;318.965.517.241.379.000;681.034.482.758.620.000
610;BENTO GONÄALVES;RS;316;148;464;318.965.517.241.379.000;681.034.482.758.620.000
203;AMêRICO BRASILIENSE;SP;316;148;464;318.965.517.241.379.000;681.034.482.758.620.000
4903;S«O PEDRO DO SUL;RS;126;59;185;318.918.918.918.918.000;681.081.081.081.081.000
3778;PêROLA;PR;94;44;138;318.840.579.710.144.000;681.159.420.289.855.000
4761;S«O JO«O DOS PATOS;MA;94;44;138;318.840.579.710.144.000;681.159.420.289.855.000
2318;ITAGIBµ;BA;203;95;298;318.791.946.308.724.000;681.208.053.691.275.000
2474;IVORµ;RS;62;29;91;318.681.318.681.318.000;681.318.681.318.681.000
4281;ROCHEDO;MS;124;58;182;318.681.318.681.318.000;681.318.681.318.681.000
589;BELêM DO BREJO DO CRUZ;PB;62;29;91;318.681.318.681.318.000;681.318.681.318.681.000
2073;HIDROL∂NDIA;GO;231;108;339;318.584.070.796.460.000;681.415.929.203.539.000
2634;JUARINA;TO;77;36;113;318.584.070.796.460.000;681.415.929.203.539.000
5402;UMARI;CE;77;36;113;318.584.070.796.460.000;681.415.929.203.539.000
1655;ELDORADO;SP;169;79;248;318.548.387.096.774.000;681.451.612.903.225.000
2167;IGUABA GRANDE;RJ;353;165;518;318.532.818.532.818.000;681.467.181.467.181.000
2417;ITAQUI;RS;184;86;270;318.518.518.518.518.000;681.481.481.481.481.000
4480;SANTA RITA;MA;199;93;292;318.493.150.684.931.000;681.506.849.315.068.000
65;µGUAS BELAS;PE;199;93;292;318.493.150.684.931.000;681.506.849.315.068.000
151;ALTO CAPARA‡;MG;107;50;157;318.471.337.579.617.000;681.528.662.420.382.000
1121;CARIDADE;CE;107;50;157;318.471.337.579.617.000;681.528.662.420.382.000
2916;MANOEL VIANA;RS;107;50;157;318.471.337.579.617.000;681.528.662.420.382.000
2336;ITAITINGA;CE;244;114;358;318.435.754.189.944.000;681.564.245.810.055.000
3847;PIO XII;MA;122;57;179;318.435.754.189.944.000;681.564.245.810.055.000
255;ANORI;AM;137;64;201;318.407.960.199.004.000;681.592.039.800.995.000
1534;CUTIAS;AP;152;71;223;318.385.650.224.215.000;681.614.349.775.784.000
1610;DOM PEDRITO;RS;180;84;264;318.181.818.181.818.000;681.818.181.818.181.000
373;AREIA DE BARAÈNAS;PB;60;28;88;318.181.818.181.818.000;681.818.181.818.181.000
609;BENTO FERNANDES;RN;90;42;132;318.181.818.181.818.000;681.818.181.818.181.000
4182;RIALMA;GO;105;49;154;318.181.818.181.818.000;681.818.181.818.181.000
2771;LAVRINHAS;SP;240;112;352;318.181.818.181.818.000;681.818.181.818.181.000
2964;MARI;PB;165;77;242;318.181.818.181.818.000;681.818.181.818.181.000
3208;MORRO DO PILAR;MG;120;56;176;318.181.818.181.818.000;681.818.181.818.181.000
3260;NATêRCIA;MG;105;49;154;318.181.818.181.818.000;681.818.181.818.181.000
5274;TIMB‡ GRANDE;SC;135;63;198;318.181.818.181.818.000;681.818.181.818.181.000
4619;S«O BENTO ABADE;MG;165;77;242;318.181.818.181.818.000;681.818.181.818.181.000
245;ANGRA DOS REIS;RJ;551;257;808;318.069.306.930.693.000;681.930.693.069.306.000
4300;RONDON DO PARµ;PA;253;118;371;318.059.299.191.374.000;681.940.700.808.625.000
2761;LASSANCE;MG;178;83;261;318.007.662.835.249.000;681.992.337.164.750.000
4847;S«O LU÷S GONZAGA DO MARANH«O;MA;178;83;261;318.007.662.835.249.000;681.992.337.164.750.000
2536;JAPARATUBA;SE;266;124;390;317.948.717.948.717.000;682.051.282.051.282.000
4089;QUATRO BARRAS;PR;191;89;280;317.857.142.857.142.000;682.142.857.142.857.000
1988;GUADALUPE;PI;88;41;129;317.829.457.364.341.000;682.170.542.635.658.000
1419;CORONEL SAPUCAIA;MS;73;34;107;317.757.009.345.794.000;682.242.990.654.205.000
1956;GOVERNADOR EDISON LOB«O;MA;204;95;299;317.725.752.508.361.000;682.274.247.491.638.000
2178;ILHA COMPRIDA;SP;204;95;299;317.725.752.508.361.000;682.274.247.491.638.000
3012;MAT«O;SP;335;156;491;317.718.940.936.863.000;682.281.059.063.136.000
2711;LAGOA DO S÷TIO;PI;58;27;85;317.647.058.823.529.000;682.352.941.176.470.000
4214;RIO BOM;PR;116;54;170;317.647.058.823.529.000;682.352.941.176.470.000
4426;SANTA GERTRUDES;SP;290;135;425;317.647.058.823.529.000;682.352.941.176.470.000
4476;SANTA MERCEDES;SP;116;54;170;317.647.058.823.529.000;682.352.941.176.470.000
118;ALHANDRA;PB;159;74;233;317.596.566.523.605.000;682.403.433.476.394.000
498;BAR«O DO TRIUNFO;RS;101;47;148;317.567.567.567.567.000;682.432.432.432.432.000
3900;PLANALTINA DO PARANµ;PR;101;47;148;317.567.567.567.567.000;682.432.432.432.432.000
2516;JAGUARIÈNA;SP;316;147;463;317.494.600.431.965.000;682.505.399.568.034.000
2604;JO«O DIAS;RN;43;20;63;317.460.317.460.317.000;682.539.682.539.682.000
3785;PETROL∂NDIA;PE;215;100;315;317.460.317.460.317.000;682.539.682.539.682.000
537;BARRA FUNDA;RS;43;20;63;317.460.317.460.317.000;682.539.682.539.682.000
1963;GOVERNADOR NEWTON BELLO;MA;129;60;189;317.460.317.460.317.000;682.539.682.539.682.000
5493;VASSOURAS;RJ;344;160;504;317.460.317.460.317.000;682.539.682.539.682.000
4931;S«O SEBASTI«O DO PASSê;BA;314;146;460;317.391.304.347.826.000;682.608.695.652.173.000
5214;TARUM«;SP;228;106;334;317.365.269.461.077.000;682.634.730.538.922.000
1467;CRISTAL∂NDIA DO PIAU÷;PI;71;33;104;317.307.692.307.692.000;682.692.307.692.307.000
1473;CRISTINµPOLIS;SE;142;66;208;317.307.692.307.692.000;682.692.307.692.307.000
997;CAMPOS DE JÈLIO;MT;71;33;104;317.307.692.307.692.000;682.692.307.692.307.000
5470;VARGEM BONITA;SC;71;33;104;317.307.692.307.692.000;682.692.307.692.307.000
3133;MOJU;PA;411;191;602;317.275.747.508.305.000;682.724.252.491.694.000
4934;S«O SEBASTI«O DO TOCANTINS;TO;99;46;145;317.241.379.310.344.000;682.758.620.689.655.000
3614;PARANAIGUARA;GO;127;59;186;317.204.301.075.268.000;682.795.698.924.731.000
3581;PAPAGAIOS;MG;127;59;186;317.204.301.075.268.000;682.795.698.924.731.000
4413;SANTA CRUZ DO SUL;RS;366;170;536;317.164.179.104.477.000;682.835.820.895.522.000
432;AURELINO LEAL;BA;183;85;268;317.164.179.104.477.000;682.835.820.895.522.000
70;µGUAS DE S«O PEDRO;SP;140;65;205;317.073.170.731.707.000;682.926.829.268.292.000
4475;SANTA MARIANA;PR;97;45;142;316.901.408.450.704.000;683.098.591.549.295.000
4610;SANT‡POLIS DO AGUAPE÷;SP;97;45;142;316.901.408.450.704.000;683.098.591.549.295.000
1114;CARDEAL DA SILVA;BA;166;77;243;316.872.427.983.539.000;683.127.572.016.460.000
947;CAMPESTRE DO MARANH«O;MA;138;64;202;316.831.683.168.316.000;683.168.316.831.683.000
1510;CUNHA POR«;SC;69;32;101;316.831.683.168.316.000;683.168.316.831.683.000
4348;SALMOUR«O;SP;138;64;202;316.831.683.168.316.000;683.168.316.831.683.000
2997;MARTINS;RN;69;32;101;316.831.683.168.316.000;683.168.316.831.683.000
5309;TRAMANDA÷;RS;207;96;303;316.831.683.168.316.000;683.168.316.831.683.000
302;ARAÄATUBA;SP;358;166;524;316.793.893.129.770.000;683.206.106.870.229.000
224;ANAPURUS;MA;110;51;161;316.770.186.335.403.000;683.229.813.664.596.000
4433;SANTA IN“S;MA;330;153;483;316.770.186.335.403.000;683.229.813.664.596.000
3485;OR‡S;CE;110;51;161;316.770.186.335.403.000;683.229.813.664.596.000
847;CACHOEIRA DA PRATA;MG;151;70;221;316.742.081.447.963.000;683.257.918.552.036.000
1477;CRIXµS DO TOCANTINS;TO;82;38;120;316.666.666.666.666.000;683.333.333.333.333.000
1216;CEARµ-MIRIM;RN;246;114;360;316.666.666.666.666.000;683.333.333.333.333.000
3541;PALHANO;CE;82;38;120;316.666.666.666.666.000;683.333.333.333.333.000
3202;MORRO AGUDO DE GOIµS;GO;82;38;120;316.666.666.666.666.000;683.333.333.333.333.000
2805;LOBATO;PR;82;38;120;316.666.666.666.666.000;683.333.333.333.333.000
4623;S«O BENTO DO TOCANTINS;TO;82;38;120;316.666.666.666.666.000;683.333.333.333.333.000
2040;GUARATINGUETµ;SP;462;214;676;316.568.047.337.278.000;683.431.952.662.721.000
1800;FILADêLFIA;TO;95;44;139;316.546.762.589.928.000;683.453.237.410.071.000
3259;NATAL∂NDIA;MG;95;44;139;316.546.762.589.928.000;683.453.237.410.071.000
352;ARARUAMA;RJ;568;263;831;316.486.161.251.504.000;683.513.838.748.495.000
2502;JACUTINGA;RS;54;25;79;316.455.696.202.531.000;683.544.303.797.468.000
2568;JATI;CE;54;25;79;316.455.696.202.531.000;683.544.303.797.468.000
4530;SANTANA DE MANGUEIRA;PB;54;25;79;316.455.696.202.531.000;683.544.303.797.468.000
1970;GRAMADO;RS;175;81;256;316.406.250.000.000.000;683.593.750.000.000.000
1834;FORMOSA DO RIO PRETO;BA;134;62;196;316.326.530.612.244.000;683.673.469.387.755.000
2211;INDIAPOR«;SP;67;31;98;316.326.530.612.244.000;683.673.469.387.755.000
2394;ITAPIRANGA;AM;201;93;294;316.326.530.612.244.000;683.673.469.387.755.000
3077;MILAGRES;BA;134;62;196;316.326.530.612.244.000;683.673.469.387.755.000
4868;S«O MIGUEL DO ALEIXO;SE;67;31;98;316.326.530.612.244.000;683.673.469.387.755.000
978;CAMPO GRANDE;MS;1031;477;1508;316.312.997.347.480.000;683.687.002.652.519.000
438;AURORA DO TOCANTINS;TO;80;37;117;316.239.316.239.316.000;683.760.683.760.683.000
1384;COQUEIRO SECO;AL;160;74;234;316.239.316.239.316.000;683.760.683.760.683.000
3634;PARECI NOVO;RS;80;37;117;316.239.316.239.316.000;683.760.683.760.683.000
3810;PILAR DO SUL;SP;160;74;234;316.239.316.239.316.000;683.760.683.760.683.000
4955;S«O VICENTE DO SUL;RS;80;37;117;316.239.316.239.316.000;683.760.683.760.683.000
5112;SOCORRO DO PIAU÷;PI;80;37;117;316.239.316.239.316.000;683.760.683.760.683.000
3160;MONTE APRAZ÷VEL;SP;173;80;253;316.205.533.596.837.000;683.794.466.403.162.000
2080;HORTOL∂NDIA;SP;545;252;797;316.185.696.361.355.000;683.814.303.638.644.000
3688;PAUL÷NIA;SP;569;263;832;316.105.769.230.769.000;683.894.230.769.230.000
2749;LAMBARI D'OESTE;MT;119;55;174;316.091.954.022.988.000;683.908.045.977.011.000
2602;JO«O C∂MARA;RN;158;73;231;316.017.316.017.316.000;683.982.683.982.683.000
4906;S«O PEDRO DOS FERROS;MG;158;73;231;316.017.316.017.316.000;683.982.683.982.683.000
2278;IRANDUBA;AM;342;158;500;316.000.000.000.000.000;684.000.000.000.000.000
2166;IGREJINHA;RS;197;91;288;315.972.222.222.222.000;684.027.777.777.777.000
4263;RIO PIRACICABA;MG;210;97;307;315.960.912.052.117.000;684.039.087.947.882.000
5057;SERRINHA;BA;405;187;592;315.878.378.378.378.000;684.121.621.621.621.000
3549;PALMAS;TO;587;271;858;315.850.815.850.815.000;684.149.184.149.184.000
3774;PERITIBA;SC;65;30;95;315.789.473.684.210.000;684.210.526.315.789.000
3754;PEJUÄARA;RS;52;24;76;315.789.473.684.210.000;684.210.526.315.789.000
2540;JAPOAT«;SE;130;60;190;315.789.473.684.210.000;684.210.526.315.789.000
2171;IGUARAÄU;PR;78;36;114;315.789.473.684.210.000;684.210.526.315.789.000
2113;IBIMIRIM;PE;182;84;266;315.789.473.684.210.000;684.210.526.315.789.000
2032;GUARANT« DO NORTE;MT;143;66;209;315.789.473.684.210.000;684.210.526.315.789.000
1636;DOUTOR RICARDO;RS;65;30;95;315.789.473.684.210.000;684.210.526.315.789.000
1682;ENTRE RIOS;BA;325;150;475;315.789.473.684.210.000;684.210.526.315.789.000
392;AROEIRAS DO ITAIM;PI;78;36;114;315.789.473.684.210.000;684.210.526.315.789.000
862;CACHOEIRINHA;RS;403;186;589;315.789.473.684.210.000;684.210.526.315.789.000
5419;UNI«O PAULISTA;SP;91;42;133;315.789.473.684.210.000;684.210.526.315.789.000
5200;TAQUARAL;SP;143;66;209;315.789.473.684.210.000;684.210.526.315.789.000
5448;VACARIA;RS;284;131;415;315.662.650.602.409.000;684.337.349.397.590.000
2429;ITATIBA;SP;499;230;729;315.500.685.871.056.000;684.499.314.128.943.000
5480;VµRZEA;RN;89;41;130;315.384.615.384.615.000;684.615.384.615.384.000
2458;ITUMBIARA;GO;254;117;371;315.363.881.401.617.000;684.636.118.598.382.000
1767;FAZENDA VILANOVA;RS;76;35;111;315.315.315.315.315.000;684.684.684.684.684.000
1991;GUAIMBê;SP;139;64;203;315.270.935.960.591.000;684.729.064.039.408.000
3990;PORTO FRANCO;MA;139;64;203;315.270.935.960.591.000;684.729.064.039.408.000
5159;TAIAÄU;SP;139;64;203;315.270.935.960.591.000;684.729.064.039.408.000
1531;CURVEL∂NDIA;MT;126;58;184;315.217.391.304.347.000;684.782.608.695.652.000
5203;TAQUARI;RS;163;75;238;315.126.050.420.168.000;684.873.949.579.831.000
1175;CµSSIA;MG;213;98;311;315.112.540.192.926.000;684.887.459.807.073.000
4302;RONDON‡POLIS;MT;526;242;768;315.104.166.666.666.000;684.895.833.333.333.000
4319;RUBINêIA;SP;100;46;146;315.068.493.150.684.000;684.931.506.849.315.000
3765;PEQUIZEIRO;TO;87;40;127;314.960.629.921.259.000;685.039.370.078.740.000
2224;INHUMA;PI;87;40;127;314.960.629.921.259.000;685.039.370.078.740.000
1632;DOURADOS;MS;459;211;670;314.925.373.134.328.000;685.074.626.865.671.000
2621;JORD∂NIA;MG;124;57;181;314.917.127.071.823.000;685.082.872.928.176.000
1362;CONDEÈBA;BA;161;74;235;314.893.617.021.276.000;685.106.382.978.723.000
4065;PRIMAVERA DO LESTE;MT;272;125;397;314.861.460.957.178.000;685.138.539.042.821.000
35;AFOGADOS DA INGAZEIRA;PE;148;68;216;314.814.814.814.814.000;685.185.185.185.185.000
5293;TOMê-AÄU;PA;370;170;540;314.814.814.814.814.000;685.185.185.185.185.000
4976;SATUBA;AL;185;85;270;314.814.814.814.814.000;685.185.185.185.185.000
4791;S«O JOSê DE RIBAMAR;MA;394;181;575;314.782.608.695.652.000;685.217.391.304.347.000
1521;CURRAIS NOVOS;RN;246;113;359;314.763.231.197.771.000;685.236.768.802.228.000
455;BAGê;RS;418;192;610;314.754.098.360.655.000;685.245.901.639.344.000
1034;CANELA;RS;172;79;251;314.741.035.856.573.000;685.258.964.143.426.000
3218;MOTUCA;SP;172;79;251;314.741.035.856.573.000;685.258.964.143.426.000
2418;ITAQUIRA÷;MS;98;45;143;314.685.314.685.314.000;685.314.685.314.685.000
4387;SANTA CARMEM;MT;98;45;143;314.685.314.685.314.000;685.314.685.314.685.000
1028;C∂NDIDO MENDES;MA;257;118;375;314.666.666.666.666.000;685.333.333.333.333.000
601;BELTERRA;PA;220;101;321;314.641.744.548.286.000;685.358.255.451.713.000
149;ALTO BELA VISTA;SC;61;28;89;314.606.741.573.033.000;685.393.258.426.966.000
1402;COROADOS;SP;122;56;178;314.606.741.573.033.000;685.393.258.426.966.000
2360;ITAMONTE;MG;146;67;213;314.553.990.610.328.000;685.446.009.389.671.000
4799;S«O JOSê DO CAMPESTRE;RN;85;39;124;314.516.129.032.258.000;685.483.870.967.741.000
4563;SANTO AMARO DO MARANH«O;MA;109;50;159;314.465.408.805.031.000;685.534.591.194.968.000
1116;CARDOSO MOREIRA;RJ;218;100;318;314.465.408.805.031.000;685.534.591.194.968.000
387;ARMAÄ«O DOS BÈZIOS;RJ;314;144;458;314.410.480.349.344.000;685.589.519.650.655.000
2376;ITAPEBI;BA;229;105;334;314.371.257.485.029.000;685.628.742.514.970.000
3594;PARA÷BA DO SUL;RJ;349;160;509;314.341.846.758.349.000;685.658.153.241.650.000
3488;OSCAR BRESSANE;SP;72;33;105;314.285.714.285.714.000;685.714.285.714.285.000
4180;RIACHUELO;RN;72;33;105;314.285.714.285.714.000;685.714.285.714.285.000
2592;JESÈPOLIS;GO;72;33;105;314.285.714.285.714.000;685.714.285.714.285.000
3268;NAZARê;TO;72;33;105;314.285.714.285.714.000;685.714.285.714.285.000
3399;NOVA TEBAS;PR;144;66;210;314.285.714.285.714.000;685.714.285.714.285.000
622;BET∂NIA;PE;72;33;105;314.285.714.285.714.000;685.714.285.714.285.000
1814;FLORESTA;PR;96;44;140;314.285.714.285.714.000;685.714.285.714.285.000
5259;TEUT‚NIA;RS;144;66;210;314.285.714.285.714.000;685.714.285.714.285.000
2340;ITAJA÷;SC;515;236;751;314.247.669.773.635.000;685.752.330.226.364.000
698;BOM JESUS DOS PERDÂES;SP;299;137;436;314.220.183.486.238.000;685.779.816.513.761.000
403;ARTUR NOGUEIRA;SP;299;137;436;314.220.183.486.238.000;685.779.816.513.761.000
4794;S«O JOSê DO BARREIRO;SP;179;82;261;314.176.245.210.727.000;685.823.754.789.272.000
299;ARAÄµS;BA;155;71;226;314.159.292.035.398.000;685.840.707.964.601.000
948;CAMPINA DA LAGOA;PR;107;49;156;314.102.564.102.564.000;685.897.435.897.435.000
1840;FORQUILHA;CE;107;49;156;314.102.564.102.564.000;685.897.435.897.435.000
798;BUENOS AIRES;PE;142;65;207;314.009.661.835.748.000;685.990.338.164.251.000
535;BARRA DO TURVO;SP;142;65;207;314.009.661.835.748.000;685.990.338.164.251.000
1717;ESP÷RITO SANTO DO PINHAL;SP;201;92;293;313.993.174.061.433.000;686.006.825.938.566.000
3394;NOVA SANTA RITA;RS;201;92;293;313.993.174.061.433.000;686.006.825.938.566.000
3353;NOVA IORQUE;MA;59;27;86;313.953.488.372.093.000;686.046.511.627.906.000
4280;ROCA SALES;RS;118;54;172;313.953.488.372.093.000;686.046.511.627.906.000
272;APARECIDA;PB;59;27;86;313.953.488.372.093.000;686.046.511.627.906.000
4793;S«O JOSê DO ALEGRE;MG;118;54;172;313.953.488.372.093.000;686.046.511.627.906.000
5064;SERTAN‡POLIS;PR;212;97;309;313.915.857.605.177.000;686.084.142.394.822.000
3897;PLACAS;PA;188;86;274;313.868.613.138.686.000;686.131.386.861.313.000
4971;SARAPU÷;SP;129;59;188;313.829.787.234.042.000;686.170.212.765.957.000
475;BALNEµRIO RINC«O;SC;105;48;153;313.725.490.196.078.000;686.274.509.803.921.000
2120;IBIRACI;MG;140;64;204;313.725.490.196.078.000;686.274.509.803.921.000
2482;JABOTICABAL;SP;396;181;577;313.691.507.798.960.000;686.308.492.201.039.000
5356;TUPACIGUARA;MG;221;101;322;313.664.596.273.291.000;686.335.403.726.708.000
1940;GOIANIRA;GO;302;138;440;313.636.363.636.363.000;686.363.636.363.636.000
2362;ITANHAêM;SP;383;175;558;313.620.071.684.587.000;686.379.928.315.412.000
230;ANDIRµ;PR;197;90;287;313.588.850.174.216.000;686.411.149.825.783.000
575;BELA VISTA;MS;162;74;236;313.559.322.033.898.000;686.440.677.966.101.000
1075;CAPIN‡POLIS;MG;162;74;236;313.559.322.033.898.000;686.440.677.966.101.000
1941;GOIANORTE;TO;81;37;118;313.559.322.033.898.000;686.440.677.966.101.000
2022;GUARA÷TA;GO;81;37;118;313.559.322.033.898.000;686.440.677.966.101.000
3489;OS‡RIO;RS;127;58;185;313.513.513.513.513.000;686.486.486.486.486.000
4357;SALTO DO JACU÷;RS;127;58;185;313.513.513.513.513.000;686.486.486.486.486.000
5372;TURUÄU;RS;127;58;185;313.513.513.513.513.000;686.486.486.486.486.000
3775;PERITOR‡;MA;173;79;252;313.492.063.492.063.000;686.507.936.507.936.000
3134;MOJU÷ DOS CAMPOS;PA;219;100;319;313.479.623.824.451.000;686.520.376.175.548.000
4275;RIOL∂NDIA;SP;138;63;201;313.432.835.820.895.000;686.567.164.179.104.000
4202;RIBEIR«O PIRES;SP;644;294;938;313.432.835.820.895.000;686.567.164.179.104.000
1747;FAGUNDES;PB;92;42;134;313.432.835.820.895.000;686.567.164.179.104.000
1220;CEDRO;CE;92;42;134;313.432.835.820.895.000;686.567.164.179.104.000
660;BOCAINA;SP;195;89;284;313.380.281.690.140.000;686.619.718.309.859.000
281;APIA÷;SP;252;115;367;313.351.498.637.602.000;686.648.501.362.397.000
3140;MONGAGUµ;SP;355;162;517;313.346.228.239.845.000;686.653.771.760.154.000
398;ARROIO DO SAL;RS;160;73;233;313.304.721.030.042.000;686.695.278.969.957.000
1403;COROATµ;MA;274;125;399;313.283.208.020.050.000;686.716.791.979.949.000
4352;SALTO;SP;548;250;798;313.283.208.020.050.000;686.716.791.979.949.000
4992;SELBACH;RS;57;26;83;313.253.012.048.192.000;686.746.987.951.807.000
4731;S«O JO«O DAS DUAS PONTES;SP;57;26;83;313.253.012.048.192.000;686.746.987.951.807.000
5261;TIANGUµ;CE;182;83;265;313.207.547.169.811.000;686.792.452.830.188.000
2341;ITAJOBI;SP;125;57;182;313.186.813.186.813.000;686.813.186.813.186.000
357;ARATUBA;CE;125;57;182;313.186.813.186.813.000;686.813.186.813.186.000
687;BOM JESUS DAS SELVAS;MA;204;93;297;313.131.313.131.313.000;686.868.686.868.686.000
3452;OLARIA;MG;68;31;99;313.131.313.131.313.000;686.868.686.868.686.000
5488;VµRZEA GRANDE;PI;68;31;99;313.131.313.131.313.000;686.868.686.868.686.000
4936;S«O SEBASTI«O DO UMBUZEIRO;PB;68;31;99;313.131.313.131.313.000;686.868.686.868.686.000
311;ARAGARÄAS;GO;283;129;412;313.106.796.116.504.000;686.893.203.883.495.000
712;BONFIM;RR;215;98;313;313.099.041.533.546.000;686.900.958.466.453.000
3129;MOGI GUAÄU;SP;384;175;559;313.059.033.989.266.000;686.940.966.010.733.000
3064;MERC“S;MG;158;72;230;313.043.478.260.869.000;686.956.521.739.130.000
2691;LAGO DO JUNCO;MA;79;36;115;313.043.478.260.869.000;686.956.521.739.130.000
2259;IPU;CE;158;72;230;313.043.478.260.869.000;686.956.521.739.130.000
3772;PERI MIRIM;MA;169;77;246;313.008.130.081.300.000;686.991.869.918.699.000
221;ANANINDEUA;PA;1148;523;1671;312.986.235.786.953.000;687.013.764.213.046.000
154;ALTO GARÄAS;MT;90;41;131;312.977.099.236.641.000;687.022.900.763.358.000
2003;GUANH«ES;MG;270;123;393;312.977.099.236.641.000;687.022.900.763.358.000
5523;VIAN‡POLIS;GO;191;87;278;312.949.640.287.769.000;687.050.359.712.230.000
2810;LORENA;SP;404;184;588;312.925.170.068.027.000;687.074.829.931.972.000
2295;ITAARA;RS;101;46;147;312.925.170.068.027.000;687.074.829.931.972.000
4834;S«O LOURENÄO;MG;301;137;438;312.785.388.127.853.000;687.214.611.872.146.000
5256;TERRA ROXA;SP;156;71;227;312.775.330.396.475.000;687.224.669.603.524.000
3781;PERU÷BE;SP;523;238;761;312.746.386.333.771.000;687.253.613.666.228.000
2298;ITABAIANINHA;SE;178;81;259;312.741.312.741.312.000;687.258.687.258.687.000
1050;CANTANHEDE;MA;189;86;275;312.727.272.727.272.000;687.272.727.272.727.000
1085;CAPIT«O POÄO;PA;200;91;291;312.714.776.632.302.000;687.285.223.367.697.000
3827;PINHAIS;PR;600;273;873;312.714.776.632.302.000;687.285.223.367.697.000
4635;S«O CAETANO DO SUL;SP;587;267;854;312.646.370.023.419.000;687.353.629.976.580.000
3734;PEDRINHAS;SE;121;55;176;312.500.000.000.000.000;687.500.000.000.000.000
3708;PEDERNEIRAS;SP;297;135;432;312.500.000.000.000.000;687.500.000.000.000.000
1117;CAREAÄU;MG;121;55;176;312.500.000.000.000.000;687.500.000.000.000.000
190;AMAPOR«;PR;110;50;160;312.500.000.000.000.000;687.500.000.000.000.000
63;AGUA÷;SP;341;155;496;312.500.000.000.000.000;687.500.000.000.000.000
99;ALCANTIL;PB;99;45;144;312.500.000.000.000.000;687.500.000.000.000.000
2150;IEP“;SP;143;65;208;312.500.000.000.000.000;687.500.000.000.000.000
1753;FARO;PA;132;60;192;312.500.000.000.000.000;687.500.000.000.000.000
1359;CONDADO;PE;187;85;272;312.500.000.000.000.000;687.500.000.000.000.000
4753;S«O JO«O DO PIAU÷;PI;99;45;144;312.500.000.000.000.000;687.500.000.000.000.000
5549;VILA RICA;MT;176;80;256;312.500.000.000.000.000;687.500.000.000.000.000
5489;VµRZEA NOVA;BA;88;40;128;312.500.000.000.000.000;687.500.000.000.000.000
670;BOITUVA;SP;295;134;429;312.354.312.354.312.000;687.645.687.645.687.000
3019;MATIAS BARBOSA;MG;262;119;381;312.335.958.005.249.000;687.664.041.994.750.000
4075;PRUDENTE DE MORAIS;MG;251;114;365;312.328.767.123.287.000;687.671.232.876.712.000
4377;SANTA BµRBARA;MG;240;109;349;312.320.916.905.444.000;687.679.083.094.555.000
487;BANDEIRANTES;PR;240;109;349;312.320.916.905.444.000;687.679.083.094.555.000
2191;IMBê;RS;174;79;253;312.252.964.426.877.000;687.747.035.573.122.000
2660;JUQUIµ;SP;315;143;458;312.227.074.235.807.000;687.772.925.764.192.000
2252;IPIXUNA;AM;119;54;173;312.138.728.323.699.000;687.861.271.676.300.000
4701;S«O GONÄALO DO AMARANTE;RN;346;157;503;312.127.236.580.516.000;687.872.763.419.483.000
3039;MATRINCH«;GO;108;49;157;312.101.910.828.025.000;687.898.089.171.974.000
3717;PEDRA DO INDAIµ;MG;108;49;157;312.101.910.828.025.000;687.898.089.171.974.000
3747;PEDRO OS‡RIO;RS;108;49;157;312.101.910.828.025.000;687.898.089.171.974.000
4538;SANTANA DO IPANEMA;AL;194;88;282;312.056.737.588.652.000;687.943.262.411.347.000
2205;INDAIATUBA;SP;463;210;673;312.035.661.218.424.000;687.964.338.781.575.000
564;BATAGUASSU;MS;183;83;266;312.030.075.187.969.000;687.969.924.812.030.000
4229;RIO DAS OSTRAS;RJ;549;249;798;312.030.075.187.969.000;687.969.924.812.030.000
2735;LAJEADO;RS;269;122;391;312.020.460.358.056.000;687.979.539.641.943.000
2723;LAGOA SALGADA;RN;86;39;125;312.000.000.000.000.000;688.000.000.000.000.000
4543;SANTANA DO MARANH«O;MA;86;39;125;312.000.000.000.000.000;688.000.000.000.000.000
3571;PALMITOS;SC;86;39;125;312.000.000.000.000.000;688.000.000.000.000.000
1013;CANµPOLIS;BA;86;39;125;312.000.000.000.000.000;688.000.000.000.000.000
844;CµCERES;MT;333;151;484;311.983.471.074.380.000;688.016.528.925.619.000
1964;GOVERNADOR NUNES FREIRE;MA;247;112;359;311.977.715.877.437.000;688.022.284.122.562.000
1190;CATANDUVAS;PR;75;34;109;311.926.605.504.587.000;688.073.394.495.412.000
3978;PORTO BELO;SC;150;68;218;311.926.605.504.587.000;688.073.394.495.412.000
2085;HUMBERTO DE CAMPOS;MA;214;97;311;311.897.106.109.324.000;688.102.893.890.675.000
583;BELµGUA;MA;128;58;186;311.827.956.989.247.000;688.172.043.010.752.000
510;BARRA BONITA;SC;64;29;93;311.827.956.989.247.000;688.172.043.010.752.000
4603;SANTO CRISTO;RS;64;29;93;311.827.956.989.247.000;688.172.043.010.752.000
1355;CONCHAS;SP;181;82;263;311.787.072.243.346.000;688.212.927.756.653.000
4252;RIO LARGO;AL;298;135;433;311.778.290.993.071.000;688.221.709.006.928.000
2933;MARACANAÈ;CE;649;294;943;311.770.943.796.394.000;688.229.056.203.605.000
4204;RIBEIR«O VERMELHO;MG;117;53;170;311.764.705.882.352.000;688.235.294.117.647.000
1282;CIDADE OCIDENTAL;GO;393;178;571;311.733.800.350.262.000;688.266.199.649.737.000
4681;S«O FRANCISCO DO CONDE;BA;329;149;478;311.715.481.171.548.000;688.284.518.828.451.000
3982;PORTO DE PEDRAS;AL;106;48;154;311.688.311.688.311.000;688.311.688.311.688.000
3885;PIRIPµ;BA;106;48;154;311.688.311.688.311.000;688.311.688.311.688.000
2743;LAJEDO DO TABOCAL;BA;106;48;154;311.688.311.688.311.000;688.311.688.311.688.000
2270;IRACEMA;RR;148;67;215;311.627.906.976.744.000;688.372.093.023.255.000
5577;VITORINO FREIRE;MA;148;67;215;311.627.906.976.744.000;688.372.093.023.255.000
2323;ITAGUAJê;PR;95;43;138;311.594.202.898.550.000;688.405.797.101.449.000
3741;PEDRO DE TOLEDO;SP;285;129;414;311.594.202.898.550.000;688.405.797.101.449.000
5348;TUIUTI;SP;190;86;276;311.594.202.898.550.000;688.405.797.101.449.000
4888;S«O PEDRO;SP;369;167;536;311.567.164.179.104.000;688.432.835.820.895.000
332;ARAPE÷;SP;137;62;199;311.557.788.944.723.000;688.442.211.055.276.000
4995;SENA MADUREIRA;AC;221;100;321;311.526.479.750.778.000;688.473.520.249.221.000
1043;CANOAS;RS;588;266;854;311.475.409.836.065.000;688.524.590.163.934.000
1243;CERRO LARGO;RS;84;38;122;311.475.409.836.065.000;688.524.590.163.934.000
3050;MAXARANGUAPE;RN;126;57;183;311.475.409.836.065.000;688.524.590.163.934.000
4919;S«O SEBASTI«O DA AMOREIRA;PR;84;38;122;311.475.409.836.065.000;688.524.590.163.934.000
2821;LU÷S ANT‚NIO;SP;241;109;350;311.428.571.428.571.000;688.571.428.571.428.000
2507;JAGUAR«O;RS;188;85;273;311.355.311.355.311.000;688.644.688.644.688.000
2586;JERIC‡;PB;73;33;106;311.320.754.716.981.000;688.679.245.283.018.000
4437;SANTA ISABEL;GO;73;33;106;311.320.754.716.981.000;688.679.245.283.018.000
644;BOA VENTURA;PB;73;33;106;311.320.754.716.981.000;688.679.245.283.018.000
5298;TORRE DE PEDRA;SP;73;33;106;311.320.754.716.981.000;688.679.245.283.018.000
233;ANDRADINA;SP;469;212;681;311.306.901.615.271.000;688.693.098.384.728.000
300;ARACATI;CE;250;113;363;311.294.765.840.220.000;688.705.234.159.779.000
3335;NOVA ESPERANÄA;PR;177;80;257;311.284.046.692.607.000;688.715.953.307.392.000
4165;RIACH«O DAS NEVES;BA;208;94;302;311.258.278.145.695.000;688.741.721.854.304.000
3582;PAPANDUVA;SC;166;75;241;311.203.319.502.074.000;688.796.680.497.925.000
119;ALIANÄA;PE;166;75;241;311.203.319.502.074.000;688.796.680.497.925.000
1630;DOURADO;SP;166;75;241;311.203.319.502.074.000;688.796.680.497.925.000
5026;SERRA;ES;881;398;1279;311.180.609.851.446.000;688.819.390.148.553.000
561;BARROSO;MG;248;112;360;311.111.111.111.111.000;688.888.888.888.888.000
4128;RANCHO ALEGRE D'OESTE;PR;62;28;90;311.111.111.111.111.000;688.888.888.888.888.000
4108;QUINZE DE NOVEMBRO;RS;62;28;90;311.111.111.111.111.000;688.888.888.888.888.000
2954;MARCELINO VIEIRA;RN;62;28;90;311.111.111.111.111.000;688.888.888.888.888.000
3490;OSVALDO CRUZ;SP;268;121;389;311.053.984.575.835.000;688.946.015.424.164.000
3174;MONTE NEGRO;RO;175;79;254;311.023.622.047.244.000;688.976.377.952.755.000
5381;UAUµ;BA;175;79;254;311.023.622.047.244.000;688.976.377.952.755.000
1667;EMBU DAS ARTES;SP;463;209;672;311.011.904.761.904.000;688.988.095.238.095.000
77;AGUDOS;SP;257;116;373;310.991.957.104.557.000;689.008.042.895.442.000
434;AURIL∂NDIA;GO;113;51;164;310.975.609.756.097.000;689.024.390.243.902.000
921;CAMAÄARI;BA;678;306;984;310.975.609.756.097.000;689.024.390.243.902.000
3016;MATERL∂NDIA;MG;113;51;164;310.975.609.756.097.000;689.024.390.243.902.000
2695;LAGOA ALEGRE;PI;113;51;164;310.975.609.756.097.000;689.024.390.243.902.000
2544;JAPURµ;PR;113;51;164;310.975.609.756.097.000;689.024.390.243.902.000
4966;SAPUCAIA DO SUL;RS;421;190;611;310.965.630.114.566.000;689.034.369.885.433.000
2705;LAGOA DE VELHOS;RN;82;37;119;310.924.369.747.899.000;689.075.630.252.100.000
2816;LUCENA;PB;164;74;238;310.924.369.747.899.000;689.075.630.252.100.000
175;µLVARES MACHADO;SP;164;74;238;310.924.369.747.899.000;689.075.630.252.100.000
5322;TR“S LAGOAS;MS;410;185;595;310.924.369.747.899.000;689.075.630.252.100.000
5460;VALINHOS;SP;501;226;727;310.866.574.965.612.000;689.133.425.034.387.000
187;AMAMBAI;MS;184;83;267;310.861.423.220.973.000;689.138.576.779.026.000
4124;RAFARD;SP;184;83;267;310.861.423.220.973.000;689.138.576.779.026.000
4737;S«O JO«O DO ARAGUAIA;PA;184;83;267;310.861.423.220.973.000;689.138.576.779.026.000
1060;CAP«O DA CANOA;RS;235;106;341;310.850.439.882.697.000;689.149.560.117.302.000
4255;RIO NEGRINHO;SC;255;115;370;310.810.810.810.810.000;689.189.189.189.189.000
3410;NOVAIS;SP;102;46;148;310.810.810.810.810.000;689.189.189.189.189.000
4667;S«O FERNANDO;RN;51;23;74;310.810.810.810.810.000;689.189.189.189.189.000
2067;HELIODORA;MG;122;55;177;310.734.463.276.836.000;689.265.536.723.163.000
4587;SANTO ANT‚NIO DO JACINTO;MG;122;55;177;310.734.463.276.836.000;689.265.536.723.163.000
2635;JUATUBA;MG;315;142;457;310.722.100.656.455.000;689.277.899.343.544.000
840;CAÄAPAVA;SP;406;183;589;310.696.095.076.400.000;689.303.904.923.599.000
1203;CATUNDA;CE;71;32;103;310.679.611.650.485.000;689.320.388.349.514.000
3093;MIRA ESTRELA;SP;71;32;103;310.679.611.650.485.000;689.320.388.349.514.000
3656;PASSAGEM;RN;71;32;103;310.679.611.650.485.000;689.320.388.349.514.000
3663;PASSO FUNDO;RS;497;224;721;310.679.611.650.485.000;689.320.388.349.514.000
3500;OURO BRANCO;MG;273;123;396;310.606.060.606.060.000;689.393.939.393.939.000
766;BRAZABRANTES;GO;91;41;132;310.606.060.606.060.000;689.393.939.393.939.000
271;APARECIDA;SP;273;123;396;310.606.060.606.060.000;689.393.939.393.939.000
2007;GUAPIMIRIM;RJ;384;173;557;310.592.459.605.026.000;689.407.540.394.973.000
4763;S«O JO«O NEPOMUCENO;MG;333;150;483;310.559.006.211.180.000;689.440.993.788.819.000
3837;PINHEIRAL;RJ;242;109;351;310.541.310.541.310.000;689.458.689.458.689.000
2575;JAURU;MT;131;59;190;310.526.315.789.473.000;689.473.684.210.526.000
2689;LAGES;SC;393;177;570;310.526.315.789.473.000;689.473.684.210.526.000
4853;S«O MANUEL;SP;342;154;496;310.483.870.967.741.000;689.516.129.032.258.000
2241;IPEÈNA;SP;191;86;277;310.469.314.079.422.000;689.530.685.920.577.000
2219;INHAMBUPE;BA;231;104;335;310.447.761.194.029.000;689.552.238.805.970.000
655;BOA VISTA DO RAMOS;AM;271;122;393;310.432.569.974.554.000;689.567.430.025.445.000
683;BOM JESUS;PB;60;27;87;310.344.827.586.206.000;689.655.172.413.793.000
406;ARVOREDO;SC;60;27;87;310.344.827.586.206.000;689.655.172.413.793.000
1316;COLINAS DO TOCANTINS;TO;220;99;319;310.344.827.586.206.000;689.655.172.413.793.000
1572;DION÷SIO CERQUEIRA;SC;120;54;174;310.344.827.586.206.000;689.655.172.413.793.000
2612;JOAQUIM FEL÷CIO;MG;120;54;174;310.344.827.586.206.000;689.655.172.413.793.000
2300;ITABERµ;SP;200;90;290;310.344.827.586.206.000;689.655.172.413.793.000
2951;MARCAÄ«O;PB;100;45;145;310.344.827.586.206.000;689.655.172.413.793.000
2873;MAGDA;SP;80;36;116;310.344.827.586.206.000;689.655.172.413.793.000
3402;NOVA UBIRAT«;MT;80;36;116;310.344.827.586.206.000;689.655.172.413.793.000
3153;MONTE ALEGRE DE GOIµS;GO;120;54;174;310.344.827.586.206.000;689.655.172.413.793.000
3918;POÄO DE JOSê DE MOURA;PB;60;27;87;310.344.827.586.206.000;689.655.172.413.793.000
3929;POMBOS;PE;160;72;232;310.344.827.586.206.000;689.655.172.413.793.000
3437;NOVO REPARTIMENTO;PA;280;126;406;310.344.827.586.206.000;689.655.172.413.793.000
3574;PANAMµ;GO;100;45;145;310.344.827.586.206.000;689.655.172.413.793.000
5005;SENADOR JOSê PORF÷RIO;PA;160;72;232;310.344.827.586.206.000;689.655.172.413.793.000
5027;SERRA ALTA;SC;60;27;87;310.344.827.586.206.000;689.655.172.413.793.000
3414;NOVO ARIPUAN«;AM;278;125;403;310.173.697.270.471.000;689.826.302.729.528.000
1469;CRISTALINA;GO;278;125;403;310.173.697.270.471.000;689.826.302.729.528.000
49;µGUA BRANCA;PI;129;58;187;310.160.427.807.486.000;689.839.572.192.513.000
3530;PAIÄANDU;PR;258;116;374;310.160.427.807.486.000;689.839.572.192.513.000
2581;JEQUIê;BA;496;223;719;310.152.990.264.255.000;689.847.009.735.744.000
179;ALVORADA;RS;485;218;703;310.099.573.257.467.000;689.900.426.742.532.000
1457;CRAVOL∂NDIA;BA;89;40;129;310.077.519.379.844.000;689.922.480.620.155.000
1274;CHOROZINHO;CE;178;80;258;310.077.519.379.844.000;689.922.480.620.155.000
3401;NOVA TRENTO;SC;89;40;129;310.077.519.379.844.000;689.922.480.620.155.000
3287;NIOAQUE;MS;178;80;258;310.077.519.379.844.000;689.922.480.620.155.000
4493;SANTA RITA DO TOCANTINS;TO;89;40;129;310.077.519.379.844.000;689.922.480.620.155.000
5517;VESPASIANO;MG;494;222;716;310.055.865.921.787.000;689.944.134.078.212.000
4160;RESTINGA;SP;158;71;229;310.043.668.122.270.000;689.956.331.877.729.000
1990;GUAIÄARA;SP;158;71;229;310.043.668.122.270.000;689.956.331.877.729.000
5579;VOLTA REDONDA;RJ;888;399;1287;310.023.310.023.310.000;689.976.689.976.689.000
1405;CORONEL BARROS;RS;69;31;100;310.000.000.000.000.000;690.000.000.000.000.000
3589;PARAGOMINAS;PA;305;137;442;309.954.751.131.221.000;690.045.248.868.778.000
1803;FLEXEIRAS;AL;118;53;171;309.941.520.467.836.000;690.058.479.532.163.000
2858;MACHADO;MG;285;128;413;309.927.360.774.818.000;690.072.639.225.181.000
697;BOM JESUS DO TOCANTINS;PA;167;75;242;309.917.355.371.900.000;690.082.644.628.099.000
2682;LµBREA;AM;216;97;313;309.904.153.354.632.000;690.095.846.645.367.000
2551;JARDIM;CE;98;44;142;309.859.154.929.577.000;690.140.845.070.422.000
2975;MARILAC;MG;98;44;142;309.859.154.929.577.000;690.140.845.070.422.000
3304;NOSSA SENHORA DO SOCORRO;SE;539;242;781;309.859.154.929.577.000;690.140.845.070.422.000
3670;PATOS;PB;343;154;497;309.859.154.929.577.000;690.140.845.070.422.000
354;ARARUNA;PR;98;44;142;309.859.154.929.577.000;690.140.845.070.422.000
171;ALUM÷NIO;SP;274;123;397;309.823.677.581.863.000;690.176.322.418.136.000
5078;SIDROL∂NDIA;MS;274;123;397;309.823.677.581.863.000;690.176.322.418.136.000
2004;GUAPê;MG;176;79;255;309.803.921.568.627.000;690.196.078.431.372.000
2076;HOLAMBRA;SP;176;79;255;309.803.921.568.627.000;690.196.078.431.372.000
4141;REDENÄ«O DO GURGUêIA;PI;78;35;113;309.734.513.274.336.000;690.265.486.725.663.000
3222;MUCAMBO;CE;78;35;113;309.734.513.274.336.000;690.265.486.725.663.000
5031;SERRA CAIADA;RN;78;35;113;309.734.513.274.336.000;690.265.486.725.663.000
4866;S«O MIGUEL DAS MISSÂES;RS;78;35;113;309.734.513.274.336.000;690.265.486.725.663.000
3277;NEPOMUCENO;MG;263;118;381;309.711.286.089.238.000;690.288.713.910.761.000
3339;NOVA EUROPA;SP;214;96;310;309.677.419.354.838.000;690.322.580.645.161.000
569;BATURITê;CE;214;96;310;309.677.419.354.838.000;690.322.580.645.161.000
4313;ROSEIRA;SP;243;109;352;309.659.090.909.090.000;690.340.909.090.909.000
4107;QUINTANA;SP;136;61;197;309.644.670.050.761.000;690.355.329.949.238.000
4918;S«O SEBASTI«O;SP;417;187;604;309.602.649.006.622.000;690.397.350.993.377.000
4823;S«O JOSê DO VALE DO RIO PRETO;RJ;223;100;323;309.597.523.219.814.000;690.402.476.780.185.000
3662;PASSO DO SOBRADO;RS;87;39;126;309.523.809.523.809.000;690.476.190.476.190.000
2294;ITµ;SC;87;39;126;309.523.809.523.809.000;690.476.190.476.190.000
2690;LAGO DA PEDRA;MA;145;65;210;309.523.809.523.809.000;690.476.190.476.190.000
1751;FARIA LEMOS;MG;116;52;168;309.523.809.523.809.000;690.476.190.476.190.000
1737;EUCLIDES DA CUNHA;BA;145;65;210;309.523.809.523.809.000;690.476.190.476.190.000
1912;GENERAL MAYNARD;SE;87;39;126;309.523.809.523.809.000;690.476.190.476.190.000
1305;COELHO NETO;MA;261;117;378;309.523.809.523.809.000;690.476.190.476.190.000
1479;CROM÷NIA;GO;87;39;126;309.523.809.523.809.000;690.476.190.476.190.000
1523;CURRAL DE DENTRO;MG;87;39;126;309.523.809.523.809.000;690.476.190.476.190.000
5228;TEJUÄUOCA;CE;116;52;168;309.523.809.523.809.000;690.476.190.476.190.000
1105;CARAPICU÷BA;SP;859;385;1244;309.485.530.546.623.000;690.514.469.453.376.000
1741;EUNµPOLIS;BA;357;160;517;309.477.756.286.266.000;690.522.243.713.733.000
4827;S«O JOSê DOS CAMPOS;SP;839;376;1215;309.465.020.576.131.000;690.534.979.423.868.000
953;CAMPINA GRANDE DO SUL;PR;270;121;391;309.462.915.601.023.000;690.537.084.398.976.000
5344;TUCUM«;PA;270;121;391;309.462.915.601.023.000;690.537.084.398.976.000
846;CACHOEIRA ALTA;GO;125;56;181;309.392.265.193.370.000;690.607.734.806.629.000
152;ALTO DO RODRIGUES;RN;96;43;139;309.352.517.985.611.000;690.647.482.014.388.000
2649;JUMIRIM;SP;96;43;139;309.352.517.985.611.000;690.647.482.014.388.000
3939;PONTAL DO PARANµ;PR;288;129;417;309.352.517.985.611.000;690.647.482.014.388.000
1701;ESCADA;PE;364;163;527;309.297.912.713.472.000;690.702.087.286.527.000
1601;DOM BAS÷LIO;BA;134;60;194;309.278.350.515.463.000;690.721.649.484.536.000
1223;CELSO RAMOS;SC;67;30;97;309.278.350.515.463.000;690.721.649.484.536.000
1878;FRONTEIRAS;PI;67;30;97;309.278.350.515.463.000;690.721.649.484.536.000
759;BRASILêIA;AC;201;90;291;309.278.350.515.463.000;690.721.649.484.536.000
1082;CAPIT«O ENêAS;MG;201;90;291;309.278.350.515.463.000;690.721.649.484.536.000
2825;LU÷S GOMES;RN;67;30;97;309.278.350.515.463.000;690.721.649.484.536.000
5237;TEODORO SAMPAIO;SP;239;107;346;309.248.554.913.294.000;690.751.445.086.705.000
4688;S«O FRANCISCO DO SUL;SC;239;107;346;309.248.554.913.294.000;690.751.445.086.705.000
3802;PIEDADE DE PONTE NOVA;MG;210;94;304;309.210.526.315.789.000;690.789.473.684.210.000
1131;CARLOS BARBOSA;RS;143;64;207;309.178.743.961.352.000;690.821.256.038.647.000
669;BOFETE;SP;143;64;207;309.178.743.961.352.000;690.821.256.038.647.000
4272;RIO VERDE;GO;505;226;731;309.165.526.675.786.000;690.834.473.324.213.000
2093;IBAITI;PR;257;115;372;309.139.784.946.236.000;690.860.215.053.763.000
3586;PARACAMBI;RJ;295;132;427;309.133.489.461.358.000;690.866.510.538.641.000
4514;SANTA TEREZINHA;MT;114;51;165;309.090.909.090.909.000;690.909.090.909.090.000
2758;LARANJAL PAULISTA;SP;190;85;275;309.090.909.090.909.000;690.909.090.909.090.000
871;CAÄU;GO;114;51;165;309.090.909.090.909.000;690.909.090.909.090.000
4654;S«O DOMINGOS DO NORTE;ES;152;68;220;309.090.909.090.909.000;690.909.090.909.090.000
401;ARROIO GRANDE;RS;123;55;178;308.988.764.044.943.000;691.011.235.955.056.000
3065;MERIDIANO;SP;85;38;123;308.943.089.430.894.000;691.056.910.569.105.000
3613;PARANA÷BA;MS;217;97;314;308.917.197.452.229.000;691.082.802.547.770.000
3136;MOMBUCA;SP;132;59;191;308.900.523.560.209.000;691.099.476.439.790.000
4306;ROSANA;SP;311;139;450;308.888.888.888.888.000;691.111.111.111.111.000
2868;M«E DO RIO;PA;226;101;327;308.868.501.529.051.000;691.131.498.470.948.000
208;AMPARO;SP;320;143;463;308.855.291.576.673.000;691.144.708.423.326.000
2182;ILHA SOLTEIRA;SP;235;105;340;308.823.529.411.764.000;691.176.470.588.235.000
1254;CHAPADA DA NATIVIDADE;TO;94;42;136;308.823.529.411.764.000;691.176.470.588.235.000
5247;TEREZ‡POLIS DE GOIµS;GO;188;84;272;308.823.529.411.764.000;691.176.470.588.235.000
2560;JARDIN‡POLIS;SP;338;151;489;308.793.456.032.719.000;691.206.543.967.280.000
4974;SARZEDO;MG;244;109;353;308.781.869.688.385.000;691.218.130.311.614.000
3768;PERDÂES;MG;197;88;285;308.771.929.824.561.000;691.228.070.175.438.000
4379;SANTA BµRBARA DO LESTE;MG;150;67;217;308.755.760.368.663.000;691.244.239.631.336.000
4632;S«O BRµS DO SUAÄU÷;MG;150;67;217;308.755.760.368.663.000;691.244.239.631.336.000
1360;CONDE;PB;271;121;392;308.673.469.387.755.000;691.326.530.612.244.000
4518;SANTA TEREZINHA DE ITAIPU;PR;168;75;243;308.641.975.308.641.000;691.358.024.691.358.000
4029;PRANCHITA;PR;56;25;81;308.641.975.308.641.000;691.358.024.691.358.000
3674;PATROC÷NIO DO MURIAê;MG;112;50;162;308.641.975.308.641.000;691.358.024.691.358.000
5285;TOCANTINS;MG;168;75;243;308.641.975.308.641.000;691.358.024.691.358.000
5319;TR“S DE MAIO;RS;112;50;162;308.641.975.308.641.000;691.358.024.691.358.000
5462;VALPARA÷SO DE GOIµS;GO;475;212;687;308.588.064.046.579.000;691.411.935.953.420.000
1812;FLORES DE GOIµS;GO;186;83;269;308.550.185.873.605.000;691.449.814.126.394.000
4983;SEABRA;BA;186;83;269;308.550.185.873.605.000;691.449.814.126.394.000
3338;NOVA ESPERANÄA DO SUL;RS;65;29;94;308.510.638.297.872.000;691.489.361.702.127.000
86;AJURICABA;RS;74;33;107;308.411.214.953.271.000;691.588.785.046.728.000
5495;VEN∂NCIO AIRES;RS;296;132;428;308.411.214.953.271.000;691.588.785.046.728.000
2624;JOSê BONIFµCIO;SP;231;103;334;308.383.233.532.934.000;691.616.766.467.065.000
5190;TAPES;RS;157;70;227;308.370.044.052.863.000;691.629.955.947.136.000
2127;IBIRAPUIT«;RS;83;37;120;308.333.333.333.333.000;691.666.666.666.666.000
2304;ITABIRA;MG;516;230;746;308.310.991.957.104.000;691.689.008.042.895.000
195;AMARANTE DO MARANH«O;MA;175;78;253;308.300.395.256.916.000;691.699.604.743.083.000
2768;LAVRAS;MG;442;197;639;308.294.209.702.660.000;691.705.790.297.339.000
2781;LE‡POLIS;PR;92;41;133;308.270.676.691.729.000;691.729.323.308.270.000
3137;MONÄ«O;MA;184;82;266;308.270.676.691.729.000;691.729.323.308.270.000
3055;MEDIANEIRA;PR;184;82;266;308.270.676.691.729.000;691.729.323.308.270.000
1188;CATAL«O;GO;368;164;532;308.270.676.691.729.000;691.729.323.308.270.000
1425;C‡RREGO FUNDO;MG;101;45;146;308.219.178.082.191.000;691.780.821.917.808.000
631;BIRIGUI;SP;440;196;636;308.176.100.628.930.000;691.823.899.371.069.000
3881;PIRAÈBA;MG;110;49;159;308.176.100.628.930.000;691.823.899.371.069.000
3875;PIRAQUARA;PR;339;151;490;308.163.265.306.122.000;691.836.734.693.877.000
5292;TOMBOS;MG;119;53;172;308.139.534.883.720.000;691.860.465.116.279.000
3186;MONTEZUMA;MG;128;57;185;308.108.108.108.108.000;691.891.891.891.891.000
1015;CANARANA;MT;128;57;185;308.108.108.108.108.000;691.891.891.891.891.000
3152;MONTE ALEGRE;PA;274;122;396;308.080.808.080.808.000;691.919.191.919.191.000
3839;PINHEIRO;MA;292;130;422;308.056.872.037.914.000;691.943.127.962.085.000
2173;IGUATEMI;MS;173;77;250;308.000.000.000.000.000;692.000.000.000.000.000
3187;MONTIVIDIU;GO;182;81;263;307.984.790.874.524.000;692.015.209.125.475.000
2841;MACA÷BA;RN;182;81;263;307.984.790.874.524.000;692.015.209.125.475.000
1689;EPITACIOL∂NDIA;AC;191;85;276;307.971.014.492.753.000;692.028.985.507.246.000
1269;CHAVES;PA;200;89;289;307.958.477.508.650.000;692.041.522.491.349.000
4445;SANTA LÈCIA;SP;236;105;341;307.917.888.563.049.000;692.082.111.436.950.000
4000;PORTO SEGURO;BA;587;261;848;307.783.018.867.924.000;692.216.981.132.075.000
749;BRAGANÄA PAULISTA;SP;695;309;1004;307.768.924.302.788.000;692.231.075.697.211.000
1019;CANAVIEIRAS;BA;243;108;351;307.692.307.692.307.000;692.307.692.307.692.000
1059;CAP«O BONITO DO SUL;RS;90;40;130;307.692.307.692.307.000;692.307.692.307.692.000
1096;CARACOL;PI;72;32;104;307.692.307.692.307.000;692.307.692.307.692.000
954;CAMPINA VERDE;MG;144;64;208;307.692.307.692.307.000;692.307.692.307.692.000
499;BARAÈNA;PB;63;28;91;307.692.307.692.307.000;692.307.692.307.692.000
490;BANZA“;BA;99;44;143;307.692.307.692.307.000;692.307.692.307.692.000
1343;CONCEIÄ«O DO ARAGUAIA;PA;261;116;377;307.692.307.692.307.000;692.307.692.307.692.000
1471;CRISTIAN‡POLIS;GO;81;36;117;307.692.307.692.307.000;692.307.692.307.692.000
2121;IBIRAÄU;ES;162;72;234;307.692.307.692.307.000;692.307.692.307.692.000
1996;GUAIÈBA;CE;171;76;247;307.692.307.692.307.000;692.307.692.307.692.000
2027;GUARANI DAS MISSÂES;RS;90;40;130;307.692.307.692.307.000;692.307.692.307.692.000
2038;GUARAREMA;SP;270;120;390;307.692.307.692.307.000;692.307.692.307.692.000
1903;GAST«O VIDIGAL;SP;90;40;130;307.692.307.692.307.000;692.307.692.307.692.000
4127;RANCHO ALEGRE;PR;81;36;117;307.692.307.692.307.000;692.307.692.307.692.000
3984;PORTO DOS GAÈCHOS;MT;81;36;117;307.692.307.692.307.000;692.307.692.307.692.000
3629;PARAÈ;RN;63;28;91;307.692.307.692.307.000;692.307.692.307.692.000
2745;LAJES PINTADAS;RN;99;44;143;307.692.307.692.307.000;692.307.692.307.692.000
2597;JOAÄABA;SC;180;80;260;307.692.307.692.307.000;692.307.692.307.692.000
2389;ITAPEVA;MG;117;52;169;307.692.307.692.307.000;692.307.692.307.692.000
3195;MORMAÄO;RS;63;28;91;307.692.307.692.307.000;692.307.692.307.692.000
4578;SANTO ANT‚NIO DE POSSE;SP;333;148;481;307.692.307.692.307.000;692.307.692.307.692.000
5335;TRIUNFO;PB;72;32;104;307.692.307.692.307.000;692.307.692.307.692.000
5562;VISTA ALEGRE;RS;63;28;91;307.692.307.692.307.000;692.307.692.307.692.000
5035;SERRA DO MEL;RN;108;48;156;307.692.307.692.307.000;692.307.692.307.692.000
5108;SOBRADO;PB;117;52;169;307.692.307.692.307.000;692.307.692.307.692.000
4738;S«O JO«O DO ARRAIAL;PI;72;32;104;307.692.307.692.307.000;692.307.692.307.692.000
4381;SANTA BµRBARA DO PARµ;PA;313;139;452;307.522.123.893.805.000;692.477.876.106.194.000
4844;S«O LU÷S DO PARAITINGA;SP;241;107;348;307.471.264.367.816.000;692.528.735.632.183.000
201;AMERICANA;SP;651;289;940;307.446.808.510.638.000;692.553.191.489.361.000
908;CAJURU;SP;214;95;309;307.443.365.695.792.000;692.556.634.304.207.000
3732;PEDREIRA;SP;214;95;309;307.443.365.695.792.000;692.556.634.304.207.000
345;ARARAQUARA;SP;588;261;849;307.420.494.699.646.000;692.579.505.300.353.000
426;AT÷LIO VIVµCQUA;ES;187;83;270;307.407.407.407.407.000;692.592.592.592.592.000
4018;POXORêU;MT;187;83;270;307.407.407.407.407.000;692.592.592.592.592.000
3381;NOVA PONTE;MG;187;83;270;307.407.407.407.407.000;692.592.592.592.592.000
950;CAMPINA DO MONTE ALEGRE;SP;160;71;231;307.359.307.359.307.000;692.640.692.640.692.000
5529;VIÄOSA;AL;151;67;218;307.339.449.541.284.000;692.660.550.458.715.000
2699;LAGOA DA PRATA;MG;293;130;423;307.328.605.200.945.000;692.671.394.799.054.000
3006;MASSARANDUBA;PB;142;63;205;307.317.073.170.731.000;692.682.926.829.268.000
4462;SANTA MARIA DA SERRA;SP;133;59;192;307.291.666.666.666.000;692.708.333.333.333.000
745;BRAÄO DO NORTE;SC;133;59;192;307.291.666.666.666.000;692.708.333.333.333.000
1775;FEL÷CIO DOS SANTOS;MG;124;55;179;307.262.569.832.402.000;692.737.430.167.597.000
4496;SANTA ROSA;RS;239;106;345;307.246.376.811.594.000;692.753.623.188.405.000
4161;RESTINGA S“CA;RS;115;51;166;307.228.915.662.650.000;692.771.084.337.349.000
4187;RIBEIRA DO AMPARO;BA;115;51;166;307.228.915.662.650.000;692.771.084.337.349.000
2116;IBIPOR«;PR;221;98;319;307.210.031.347.962.000;692.789.968.652.037.000
2145;ICêM;SP;212;94;306;307.189.542.483.660.000;692.810.457.516.339.000
3069;MESQUITA;RJ;600;266;866;307.159.353.348.729.000;692.840.646.651.270.000
3199;MORRINHOS;CE;97;43;140;307.142.857.142.857.000;692.857.142.857.142.000
3159;MONTE ALTO;SP;291;129;420;307.142.857.142.857.000;692.857.142.857.142.000
1206;CATURITê;PB;97;43;140;307.142.857.142.857.000;692.857.142.857.142.000
5440;URUGUAIANA;RS;291;129;420;307.142.857.142.857.000;692.857.142.857.142.000
2926;MARABµ;PA;670;297;967;307.135.470.527.404.000;692.864.529.472.595.000
2849;MACATUBA;SP;282;125;407;307.125.307.125.307.000;692.874.692.874.692.000
4010;POTIM;SP;282;125;407;307.125.307.125.307.000;692.874.692.874.692.000
2181;ILHA GRANDE;PI;185;82;267;307.116.104.868.913.000;692.883.895.131.086.000
1734;ESTRELA DO SUL;MG;88;39;127;307.086.614.173.228.000;692.913.385.826.771.000
937;CAMBUQUIRA;MG;176;78;254;307.086.614.173.228.000;692.913.385.826.771.000
374;AREIAL;PB;88;39;127;307.086.614.173.228.000;692.913.385.826.771.000
5332;TRINDADE;PE;88;39;127;307.086.614.173.228.000;692.913.385.826.771.000
1890;GAMELEIRA;PE;255;113;368;307.065.217.391.304.000;692.934.782.608.695.000
5333;TRINDADE;GO;510;226;736;307.065.217.391.304.000;692.934.782.608.695.000
5301;TOUROS;RN;167;74;241;307.053.941.908.713.000;692.946.058.091.286.000
4678;S«O FRANCISCO DE PAULA;RS;167;74;241;307.053.941.908.713.000;692.946.058.091.286.000
5198;TAQUARA;RS;246;109;355;307.042.253.521.126.000;692.957.746.478.873.000
1888;GALINHOS;RN;79;35;114;307.017.543.859.649.000;692.982.456.140.350.000
1400;CORNêLIO PROC‡PIO;PR;316;140;456;307.017.543.859.649.000;692.982.456.140.350.000
153;ALTO FELIZ;RS;79;35;114;307.017.543.859.649.000;692.982.456.140.350.000
881;CAFEL∂NDIA;SP;237;105;342;307.017.543.859.649.000;692.982.456.140.350.000
692;BOM JESUS DO ITABAPOANA;RJ;316;140;456;307.017.543.859.649.000;692.982.456.140.350.000
5365;TUPIRAMA;TO;79;35;114;307.017.543.859.649.000;692.982.456.140.350.000
2505;JAGUAQUARA;BA;219;97;316;306.962.025.316.455.000;693.037.974.683.544.000
2554;JARDIM DE ANGICOS;RN;70;31;101;306.930.693.069.306.000;693.069.306.930.693.000
4224;RIO CLARO;SP;621;275;896;306.919.642.857.142.000;693.080.357.142.857.000
3823;PINDORAMA;SP;131;58;189;306.878.306.878.306.000;693.121.693.121.693.000
551;BARRINHA;SP;314;139;453;306.843.267.108.167.000;693.156.732.891.832.000
586;BELêM;PB;122;54;176;306.818.181.818.181.000;693.181.818.181.818.000
919;CALUMBI;PE;61;27;88;306.818.181.818.181.000;693.181.818.181.818.000
2154;IGARACY;PB;61;27;88;306.818.181.818.181.000;693.181.818.181.818.000
3675;PATROC÷NIO PAULISTA;SP;183;81;264;306.818.181.818.181.000;693.181.818.181.818.000
3704;PAVUSSU;PI;61;27;88;306.818.181.818.181.000;693.181.818.181.818.000
2567;JATE÷;MS;61;27;88;306.818.181.818.181.000;693.181.818.181.818.000
1514;CURAÄµ;BA;174;77;251;306.772.908.366.533.000;693.227.091.633.466.000
705;BOM RETIRO DO SUL;RS;113;50;163;306.748.466.257.668.000;693.251.533.742.331.000
2432;ITATINGA;SP;226;100;326;306.748.466.257.668.000;693.251.533.742.331.000
5257;TERRA SANTA;PA;113;50;163;306.748.466.257.668.000;693.251.533.742.331.000
5134;SUMARê;SP;712;315;1027;306.718.597.857.838.000;693.281.402.142.161.000
1529;CURUÄµ;PA;321;142;463;306.695.464.362.850.000;693.304.535.637.149.000
1663;EL‡I MENDES;MG;156;69;225;306.666.666.666.666.000;693.333.333.333.333.000
1152;CARNEIROS;AL;104;46;150;306.666.666.666.666.000;693.333.333.333.333.000
2715;LAGOA DOS TR“S CANTOS;RS;52;23;75;306.666.666.666.666.000;693.333.333.333.333.000
2949;MARAVILHA;SC;104;46;150;306.666.666.666.666.000;693.333.333.333.333.000
3512;OUROL∂NDIA;BA;104;46;150;306.666.666.666.666.000;693.333.333.333.333.000
4198;RIBEIR«O DO PINHAL;PR;156;69;225;306.666.666.666.666.000;693.333.333.333.333.000
4988;SEBASTI«O LEAL;PI;52;23;75;306.666.666.666.666.000;693.333.333.333.333.000
3333;NOVA ERA;MG;199;88;287;306.620.209.059.233.000;693.379.790.940.766.000
3611;PARANACITY;PR;147;65;212;306.603.773.584.905.000;693.396.226.415.094.000
990;CAMPO NOVO DE ROND‚NIA;RO;147;65;212;306.603.773.584.905.000;693.396.226.415.094.000
4829;S«O JOSê DOS PINHAIS;PR;735;325;1060;306.603.773.584.905.000;693.396.226.415.094.000
4153;RESENDE;RJ;683;302;985;306.598.984.771.573.000;693.401.015.228.426.000
1808;FLOR∂NIA;RN;95;42;137;306.569.343.065.693.000;693.430.656.934.306.000
4842;S«O LU÷S DE MONTES BELOS;GO;181;80;261;306.513.409.961.685.000;693.486.590.038.314.000
4088;QUATIS;RJ;267;118;385;306.493.506.493.506.000;693.506.493.506.493.000
2685;LADµRIO;MS;310;137;447;306.487.695.749.440.000;693.512.304.250.559.000
2339;ITAJµ;RN;86;38;124;306.451.612.903.225.000;693.548.387.096.774.000
3819;PINDAMONHANGABA;SP;430;190;620;306.451.612.903.225.000;693.548.387.096.774.000
1694;êRICO CARDOSO;BA;86;38;124;306.451.612.903.225.000;693.548.387.096.774.000
461;BAI«O;PA;172;76;248;306.451.612.903.225.000;693.548.387.096.774.000
394;ARRAIAL DO CABO;RJ;301;133;434;306.451.612.903.225.000;693.548.387.096.774.000
5101;S÷TIO DO MATO;BA;172;76;248;306.451.612.903.225.000;693.548.387.096.774.000
2788;LIMEIRA;SP;765;338;1103;306.436.990.027.198.000;693.563.009.972.801.000
3558;PALMEIRAIS;PI;120;53;173;306.358.381.502.890.000;693.641.618.497.109.000
325;ARAL MOREIRA;MS;120;53;173;306.358.381.502.890.000;693.641.618.497.109.000
3585;PARµ DE MINAS;MG;557;246;803;306.351.183.063.511.000;693.648.816.936.488.000
5367;TURIAÄU;MA;317;140;457;306.345.733.041.575.000;693.654.266.958.424.000
1528;CURUµ;PA;197;87;284;306.338.028.169.014.000;693.661.971.830.985.000
3496;OURINHOS;SP;351;155;506;306.324.110.671.936.000;693.675.889.328.063.000
3783;PESCARIA BRAVA;SC;77;34;111;306.306.306.306.306.000;693.693.693.693.693.000
3301;NOSSA SENHORA DE LOURDES;SE;77;34;111;306.306.306.306.306.000;693.693.693.693.693.000
417;ASSUNÄ«O DO PIAU÷;PI;77;34;111;306.306.306.306.306.000;693.693.693.693.693.000
4769;S«O JORGE DO IVA÷;PR;77;34;111;306.306.306.306.306.000;693.693.693.693.693.000
851;CACHOEIRA DO ARARI;PA;188;83;271;306.273.062.730.627.000;693.726.937.269.372.000
3234;MUNDO NOVO;MS;145;64;209;306.220.095.693.779.000;693.779.904.306.220.000
4594;SANTO ANT‚NIO DO PINHAL;SP;145;64;209;306.220.095.693.779.000;693.779.904.306.220.000
863;CACHOEIRO DE ITAPEMIRIM;ES;648;286;934;306.209.850.107.066.000;693.790.149.892.933.000
1633;DOUTOR CAMARGO;PR;102;45;147;306.122.448.979.591.000;693.877.551.020.408.000
1754;FAROL;PR;102;45;147;306.122.448.979.591.000;693.877.551.020.408.000
2929;MARACA÷;SP;204;90;294;306.122.448.979.591.000;693.877.551.020.408.000
4201;RIBEIR«O GRANDE;SP;136;60;196;306.122.448.979.591.000;693.877.551.020.408.000
4522;SANTA VIT‡RIA DO PALMAR;RS;204;90;294;306.122.448.979.591.000;693.877.551.020.408.000
4554;SANTARêM;PA;612;270;882;306.122.448.979.591.000;693.877.551.020.408.000
4744;S«O JO«O DO JAGUARIBE;CE;68;30;98;306.122.448.979.591.000;693.877.551.020.408.000
5560;VISCONDE DO RIO BRANCO;MG;195;86;281;306.049.822.064.056.000;693.950.177.935.943.000
647;BOA VISTA;RR;746;329;1075;306.046.511.627.906.000;693.953.488.372.093.000
2233;IPANGUAÄU;RN;161;71;232;306.034.482.758.620.000;693.965.517.241.379.000
5238;TEOFIL∂NDIA;BA;161;71;232;306.034.482.758.620.000;693.965.517.241.379.000
570;BAURU;SP;576;254;830;306.024.096.385.542.000;693.975.903.614.457.000
2572;JAÈ;SP;474;209;683;306.002.928.257.686.000;693.997.071.742.313.000
2703;LAGOA DE PEDRAS;RN;93;41;134;305.970.149.253.731.000;694.029.850.746.268.000
3458;OLHO D'µGUA DO CASADO;AL;93;41;134;305.970.149.253.731.000;694.029.850.746.268.000
2932;MARACAN«;PA;245;108;353;305.949.008.498.583.000;694.050.991.501.416.000
3612;PARANAGUµ;PR;608;268;876;305.936.073.059.360.000;694.063.926.940.639.000
3862;PIRAMBU;SE;152;67;219;305.936.073.059.360.000;694.063.926.940.639.000
3858;PIRA÷ DO SUL;PR;211;93;304;305.921.052.631.578.000;694.078.947.368.421.000
3194;MORENO;PE;329;145;474;305.907.172.995.780.000;694.092.827.004.219.000
2673;JUSSARA;PR;118;52;170;305.882.352.941.176.000;694.117.647.058.823.000
3866;PIRANGUINHO;MG;177;78;255;305.882.352.941.176.000;694.117.647.058.823.000
4384;SANTA BµRBARA D'OESTE;SP;706;311;1017;305.801.376.597.836.000;694.198.623.402.163.000
4258;RIO NOVO;MG;168;74;242;305.785.123.966.942.000;694.214.876.033.057.000
3998;PORTO RICO;PR;84;37;121;305.785.123.966.942.000;694.214.876.033.057.000
3230;MULUNGU;PB;84;37;121;305.785.123.966.942.000;694.214.876.033.057.000
1809;FLOREAL;SP;84;37;121;305.785.123.966.942.000;694.214.876.033.057.000
5277;TIM‡TEO;MG;445;196;641;305.772.230.889.235.000;694.227.769.110.764.000
112;ALFENAS;MG;361;159;520;305.769.230.769.230.000;694.230.769.230.769.000
3578;PANORAMA;SP;193;85;278;305.755.395.683.453.000;694.244.604.316.546.000
521;BARRA DO BUGRES;MT;302;133;435;305.747.126.436.781.000;694.252.873.563.218.000
460;BAIAN‡POLIS;BA;109;48;157;305.732.484.076.433.000;694.267.515.923.566.000
1265;CHARQUEADAS;RS;243;107;350;305.714.285.714.285.000;694.285.714.285.714.000
1862;FRANCISCO MORATO;SP;536;236;772;305.699.481.865.284.000;694.300.518.134.715.000
4449;SANTA LUZIA;MA;268;118;386;305.699.481.865.284.000;694.300.518.134.715.000
857;CACHOEIRA GRANDE;MA;159;70;229;305.676.855.895.196.000;694.323.144.104.803.000
1062;CAP«O DO LE«O;RS;209;92;301;305.647.840.531.561.000;694.352.159.468.438.000
5466;VARGEM;SP;209;92;301;305.647.840.531.561.000;694.352.159.468.438.000
623;BET∂NIA DO PIAU÷;PI;50;22;72;305.555.555.555.555.000;694.444.444.444.444.000
478;BALSAS;MA;375;165;540;305.555.555.555.555.000;694.444.444.444.444.000
1189;CATANDUVA;SP;375;165;540;305.555.555.555.555.000;694.444.444.444.444.000
1353;CONCEIÄ«O DOS OUROS;MG;125;55;180;305.555.555.555.555.000;694.444.444.444.444.000
4428;SANTA HELENA;PR;100;44;144;305.555.555.555.555.000;694.444.444.444.444.000
4329;SACRAMENTO;MG;200;88;288;305.555.555.555.555.000;694.444.444.444.444.000
3702;PAV«O;MG;125;55;180;305.555.555.555.555.000;694.444.444.444.444.000
3363;NOVA MARIL∂NDIA;MT;75;33;108;305.555.555.555.555.000;694.444.444.444.444.000
2346;ITALVA;RJ;200;88;288;305.555.555.555.555.000;694.444.444.444.444.000
5305;TRAIPU;AL;125;55;180;305.555.555.555.555.000;694.444.444.444.444.000
4852;S«O MANOEL DO PARANµ;PR;75;33;108;305.555.555.555.555.000;694.444.444.444.444.000
4641;S«O CRIST‡V«O DO SUL;SC;75;33;108;305.555.555.555.555.000;694.444.444.444.444.000
5474;VARGEM GRANDE PAULISTA;SP;266;117;383;305.483.028.720.626.000;694.516.971.279.373.000
4327;SABIN‡POLIS;MG;166;73;239;305.439.330.543.933.000;694.560.669.456.066.000
884;CAIABU;SP;166;73;239;305.439.330.543.933.000;694.560.669.456.066.000
3752;PEIXE-BOI;PA;141;62;203;305.418.719.211.822.000;694.581.280.788.177.000
2863;MADALENA;CE;116;51;167;305.389.221.556.886.000;694.610.778.443.113.000
1309;COLARES;PA;232;102;334;305.389.221.556.886.000;694.610.778.443.113.000
563;BASTOS;SP;182;80;262;305.343.511.450.381.000;694.656.488.549.618.000
3116;MIRASSOL∂NDIA;SP;91;40;131;305.343.511.450.381.000;694.656.488.549.618.000
3266;NAVIRA÷;MS;248;109;357;305.322.128.851.540.000;694.677.871.148.459.000
3559;PALMEIR∂NDIA;MA;248;109;357;305.322.128.851.540.000;694.677.871.148.459.000
4096;QUEIMADAS;PB;314;138;452;305.309.734.513.274.000;694.690.265.486.725.000
88;ALAGOA GRANDE;PB;157;69;226;305.309.734.513.274.000;694.690.265.486.725.000
2247;IPIRANGA;PR;157;69;226;305.309.734.513.274.000;694.690.265.486.725.000
5050;SERRANO DO MARANH«O;MA;157;69;226;305.309.734.513.274.000;694.690.265.486.725.000
796;BUENO BRAND«O;MG;132;58;190;305.263.157.894.736.000;694.736.842.105.263.000
4179;RIACHO FRIO;PI;66;29;95;305.263.157.894.736.000;694.736.842.105.263.000
2905;MANDURI;SP;132;58;190;305.263.157.894.736.000;694.736.842.105.263.000
4883;S«O PATR÷CIO;GO;66;29;95;305.263.157.894.736.000;694.736.842.105.263.000
3216;MOSSOR‡;RN;610;268;878;305.239.179.954.441.000;694.760.820.045.558.000
4341;SALGADO DE S«O FêLIX;PB;107;47;154;305.194.805.194.805.000;694.805.194.805.194.000
4399;SANTA CRUZ DA BAIXA VERDE;PE;148;65;213;305.164.319.248.826.000;694.835.680.751.173.000
501;BARBACENA;MG;501;220;721;305.131.761.442.441.000;694.868.238.557.558.000
3677;PATY DO ALFERES;RJ;353;155;508;305.118.110.236.220.000;694.881.889.763.779.000
3666;PASTOS BONS;MA;82;36;118;305.084.745.762.711.000;694.915.254.237.288.000
3657;PASSAGEM FRANCA;MA;82;36;118;305.084.745.762.711.000;694.915.254.237.288.000
4544;SANTANA DO MATOS;RN;82;36;118;305.084.745.762.711.000;694.915.254.237.288.000
4183;RIANµPOLIS;GO;82;36;118;305.084.745.762.711.000;694.915.254.237.288.000
1065;CAPELA;SE;164;72;236;305.084.745.762.711.000;694.915.254.237.288.000
2764;LAURO DE FREITAS;BA;647;284;931;305.048.335.123.523.000;694.951.664.876.476.000
4359;SALTO GRANDE;SP;221;97;318;305.031.446.540.880.000;694.968.553.459.119.000
4139;REDENÄ«O;CE;180;79;259;305.019.305.019.305.000;694.980.694.980.694.000
1492;CRUZEIRO DO SUL;RS;139;61;200;305.000.000.000.000.000;695.000.000.000.000.000
3988;PORTO FERREIRA;SP;376;165;541;304.990.757.855.822.000;695.009.242.144.177.000
3733;PEDREIRAS;MA;237;104;341;304.985.337.243.401.000;695.014.662.756.598.000
3682;PAU DOS FERROS;RN;98;43;141;304.964.539.007.092.000;695.035.460.992.907.000
869;CACOAL;RO;253;111;364;304.945.054.945.054.000;695.054.945.054.945.000
2060;GURINHêM;PB;114;50;164;304.878.048.780.487.000;695.121.951.219.512.000
1771;FEIRA GRANDE;AL;114;50;164;304.878.048.780.487.000;695.121.951.219.512.000
4392;SANTA CEC÷LIA DO SUL;RS;57;25;82;304.878.048.780.487.000;695.121.951.219.512.000
2311;ITACARAMBI;MG;114;50;164;304.878.048.780.487.000;695.121.951.219.512.000
4797;S«O JOSê DO BREJO DO CRUZ;PB;57;25;82;304.878.048.780.487.000;695.121.951.219.512.000
4345;SALINAS DA MARGARIDA;BA;244;107;351;304.843.304.843.304.000;695.156.695.156.695.000
1778;FELIXL∂NDIA;MG;187;82;269;304.832.713.754.646.000;695.167.286.245.353.000
1923;GLICêRIO;SP;130;57;187;304.812.834.224.598.000;695.187.165.775.401.000
1338;CONCEIÄ«O DAS ALAGOAS;MG;130;57;187;304.812.834.224.598.000;695.187.165.775.401.000
5580;VOTORANTIM;SP;463;203;666;304.804.804.804.804.000;695.195.195.195.195.000
1465;CRISTAL DO SUL;RS;73;32;105;304.761.904.761.904.000;695.238.095.238.095.000
228;ANCHIETA;SC;73;32;105;304.761.904.761.904.000;695.238.095.238.095.000
2314;ITACURUBA;PE;73;32;105;304.761.904.761.904.000;695.238.095.238.095.000
2296;ITABAIANA;SE;146;64;210;304.761.904.761.904.000;695.238.095.238.095.000
3144;MONSENHOR PAULO;MG;73;32;105;304.761.904.761.904.000;695.238.095.238.095.000
3497;OURIZONA;PR;89;39;128;304.687.500.000.000.000;695.312.500.000.000.000
213;ANADIA;AL;89;39;128;304.687.500.000.000.000;695.312.500.000.000.000
5341;TROMBUDO CENTRAL;SC;89;39;128;304.687.500.000.000.000;695.312.500.000.000.000
1094;CARACARA÷;RR;283;124;407;304.668.304.668.304.000;695.331.695.331.695.000
4215;RIO BONITO;RJ;283;124;407;304.668.304.668.304.000;695.331.695.331.695.000
3412;NOVO AIR«O;AM;299;131;430;304.651.162.790.697.000;695.348.837.209.302.000
4060;PRESIDENTE VARGAS;MA;137;60;197;304.568.527.918.781.000;695.431.472.081.218.000
1153;CAROEBE;RR;137;60;197;304.568.527.918.781.000;695.431.472.081.218.000
2180;ILHA DE ITAMARACµ;PE;153;67;220;304.545.454.545.454.000;695.454.545.454.545.000
2404;ITAPOR«;MS;153;67;220;304.545.454.545.454.000;695.454.545.454.545.000
2002;GUANAMBI;BA;169;74;243;304.526.748.971.193.000;695.473.251.028.806.000
3854;PIRACICABA;SP;852;373;1225;304.489.795.918.367.000;695.510.204.081.632.000
3197;MORRETES;PR;265;116;381;304.461.942.257.217.000;695.538.057.742.782.000
1264;CHARQUEADA;SP;297;130;427;304.449.648.711.943.000;695.550.351.288.056.000
1178;CASTANHAL;PA;601;263;864;304.398.148.148.148.000;695.601.851.851.851.000
1538;DARCIN‡POLIS;TO;112;49;161;304.347.826.086.956.000;695.652.173.913.043.000
681;BOM JESUS;RN;80;35;115;304.347.826.086.956.000;695.652.173.913.043.000
186;AMAJARI;RR;160;70;230;304.347.826.086.956.000;695.652.173.913.043.000
123;ALMEIRIM;PA;240;105;345;304.347.826.086.956.000;695.652.173.913.043.000
2786;LIMA CAMPOS;MA;80;35;115;304.347.826.086.956.000;695.652.173.913.043.000
3706;PEABIRU;PR;160;70;230;304.347.826.086.956.000;695.652.173.913.043.000
3652;PASSA TEMPO;MG;160;70;230;304.347.826.086.956.000;695.652.173.913.043.000
5346;TUCURU÷;PA;423;185;608;304.276.315.789.473.000;695.723.684.210.526.000
1263;CHAPEC‡;SC;327;143;470;304.255.319.148.936.000;695.744.680.851.063.000
4501;SANTA ROSA DE VITERBO;SP;231;101;332;304.216.867.469.879.000;695.783.132.530.120.000
659;BOCA DO ACRE;AM;199;87;286;304.195.804.195.804.000;695.804.195.804.195.000
4696;S«O GERALDO DO ARAGUAIA;PA;199;87;286;304.195.804.195.804.000;695.804.195.804.195.000
942;CAMPANHA;MG;183;80;263;304.182.509.505.703.000;695.817.490.494.296.000
5530;VIÄOSA;MG;453;198;651;304.147.465.437.788.000;695.852.534.562.211.000
1435;CORUMBATA÷;SP;135;59;194;304.123.711.340.206.000;695.876.288.659.793.000
664;BOCAIÈVA;MG;373;163;536;304.104.477.611.940.000;695.895.522.388.059.000
359;ARAUµ;SE;119;52;171;304.093.567.251.461.000;695.906.432.748.538.000
4058;PRESIDENTE SARNEY;MA;238;104;342;304.093.567.251.461.000;695.906.432.748.538.000
1148;CARNAUBAIS;RN;103;45;148;304.054.054.054.054.000;695.945.945.945.945.000
5457;VALENÄA DO PIAU÷;PI;103;45;148;304.054.054.054.054.000;695.945.945.945.945.000
16;AÄAIL∂NDIA;MA;396;173;569;304.042.179.261.862.000;695.957.820.738.137.000
973;CAMPO DO MEIO;MG;190;83;273;304.029.304.029.304.000;695.970.695.970.695.000
4456;SANTA LUZIA DO PARUµ;MA;190;83;273;304.029.304.029.304.000;695.970.695.970.695.000
2352;ITAMARI;BA;87;38;125;304.000.000.000.000.000;696.000.000.000.000.000
926;CAMAPU«;MS;174;76;250;304.000.000.000.000.000;696.000.000.000.000.000
3478;ORIXIMINµ;PA;229;100;329;303.951.367.781.155.000;696.048.632.218.844.000
2877;MAIRINQUE;SP;442;193;635;303.937.007.874.015.000;696.062.992.125.984.000
3284;NIL‡POLIS;RJ;513;224;737;303.934.871.099.050.000;696.065.128.900.949.000
2985;MARIPµ;PR;71;31;102;303.921.568.627.450.000;696.078.431.372.549.000
3102;MIRA÷;MG;142;62;204;303.921.568.627.450.000;696.078.431.372.549.000
3042;MATURêIA;PB;71;31;102;303.921.568.627.450.000;696.078.431.372.549.000
3933;PONGA÷;SP;71;31;102;303.921.568.627.450.000;696.078.431.372.549.000
4130;RAPOSA;MA;252;110;362;303.867.403.314.917.000;696.132.596.685.082.000
2813;LOUVEIRA;SP;433;189;622;303.858.520.900.321.000;696.141.479.099.678.000
4230;RIO DAS PEDRAS;SP;307;134;441;303.854.875.283.446.000;696.145.124.716.553.000
73;µGUAS LINDAS DE GOIµS;GO;582;254;836;303.827.751.196.172.000;696.172.248.803.827.000
4516;SANTA TEREZINHA;BA;110;48;158;303.797.468.354.430.000;696.202.531.645.569.000
3443;NOVO XINGU;RS;55;24;79;303.797.468.354.430.000;696.202.531.645.569.000
2508;JAGUARARI;BA;220;96;316;303.797.468.354.430.000;696.202.531.645.569.000
1165;CASA NOVA;BA;259;113;372;303.763.440.860.215.000;696.236.559.139.784.000
5276;TIMON;MA;541;236;777;303.732.303.732.303.000;696.267.696.267.696.000
3936;PONTA POR«;MS;337;147;484;303.719.008.264.462.000;696.280.991.735.537.000
3898;PLµCIDO DE CASTRO;AC;188;82;270;303.703.703.703.703.000;696.296.296.296.296.000
3735;PEDRINHAS PAULISTA;SP;94;41;135;303.703.703.703.703.000;696.296.296.296.296.000
4328;SABOEIRO;CE;94;41;135;303.703.703.703.703.000;696.296.296.296.296.000
2338;ITAJµ;GO;94;41;135;303.703.703.703.703.000;696.296.296.296.296.000
497;BAR«O DE MONTE ALTO;MG;94;41;135;303.703.703.703.703.000;696.296.296.296.296.000
716;BONFIN‡POLIS DE MINAS;MG;94;41;135;303.703.703.703.703.000;696.296.296.296.296.000
4771;S«O JORGE D'OESTE;PR;94;41;135;303.703.703.703.703.000;696.296.296.296.296.000
4839;S«O LOURENÄO DO SUL;RS;188;82;270;303.703.703.703.703.000;696.296.296.296.296.000
169;ALT‚NIA;PR;133;58;191;303.664.921.465.968.000;696.335.078.534.031.000
3157;MONTE ALEGRE DO SUL;SP;172;75;247;303.643.724.696.356.000;696.356.275.303.643.000
1409;CORONEL FABRICIANO;MG;422;184;606;303.630.363.036.303.000;696.369.636.963.696.000
4147;REGISTRO;SP;445;194;639;303.599.374.021.909.000;696.400.625.978.090.000
2973;MARIBONDO;AL;117;51;168;303.571.428.571.428.000;696.428.571.428.571.000
2453;ITU;SP;585;255;840;303.571.428.571.428.000;696.428.571.428.571.000
1276;CHU÷;RS;117;51;168;303.571.428.571.428.000;696.428.571.428.571.000
1870;FREI INOC“NCIO;MG;195;85;280;303.571.428.571.428.000;696.428.571.428.571.000
108;ALêM PARA÷BA;MG;312;136;448;303.571.428.571.428.000;696.428.571.428.571.000
1018;CANAVIEIRA;PI;78;34;112;303.571.428.571.428.000;696.428.571.428.571.000
2374;ITAPARICA;BA;257;112;369;303.523.035.230.352.000;696.476.964.769.647.000
2509;JAGUARê;ES;218;95;313;303.514.376.996.805.000;696.485.623.003.194.000
1313;COLINAS;MA;140;61;201;303.482.587.064.676.000;696.517.412.935.323.000
5253;TERRA NOVA DO NORTE;MT;140;61;201;303.482.587.064.676.000;696.517.412.935.323.000
4870;S«O MIGUEL DO ARAGUAIA;GO;241;105;346;303.468.208.092.485.000;696.531.791.907.514.000
155;ALTO HORIZONTE;GO;101;44;145;303.448.275.862.068.000;696.551.724.137.931.000
4582;SANTO ANTONIO DO CAIUµ;PR;101;44;145;303.448.275.862.068.000;696.551.724.137.931.000
3762;PENTECOSTE;CE;225;98;323;303.405.572.755.417.000;696.594.427.244.582.000
1846;FORTALEZA DOS VALOS;RS;62;27;89;303.370.786.516.853.000;696.629.213.483.146.000
4616;S«O BENTINHO;PB;62;27;89;303.370.786.516.853.000;696.629.213.483.146.000
5161;TAI‡;SC;124;54;178;303.370.786.516.853.000;696.629.213.483.146.000
5140;SUZANO;SP;928;404;1332;303.303.303.303.303.000;696.696.696.696.696.000
5219;TAUBATê;SP;719;313;1032;303.294.573.643.410.000;696.705.426.356.589.000
3044;MAUµ;SP;889;387;1276;303.291.536.050.156.000;696.708.463.949.843.000
1325;COLORADO;RS;85;37;122;303.278.688.524.590.000;696.721.311.475.409.000
1515;CURIMATµ;PI;85;37;122;303.278.688.524.590.000;696.721.311.475.409.000
2156;IGARAPê;MG;409;178;587;303.236.797.274.275.000;696.763.202.725.724.000
5289;TOLEDO;PR;455;198;653;303.215.926.493.108.000;696.784.073.506.891.000
1692;ERECHIM;RS;347;151;498;303.212.851.405.622.000;696.787.148.594.377.000
1196;CATIGUµ;SP;131;57;188;303.191.489.361.702.000;696.808.510.638.297.000
4196;RIBEIR«O DAS NEVES;MG;593;258;851;303.172.737.955.346.000;696.827.262.044.653.000
3214;MORUNGABA;SP;177;77;254;303.149.606.299.212.000;696.850.393.700.787.000
5490;VµRZEA PAULISTA;SP;430;187;617;303.079.416.531.604.000;696.920.583.468.395.000
3021;MATIAS OL÷MPIO;PI;92;40;132;303.030.303.030.303.000;696.969.696.969.696.000
2779;LEOPOLDINA;MG;460;200;660;303.030.303.030.303.000;696.969.696.969.696.000
1543;DAVIN‡POLIS;MA;184;80;264;303.030.303.030.303.000;696.969.696.969.696.000
279;APIACµ;ES;161;70;231;303.030.303.030.303.000;696.969.696.969.696.000
346;ARARAS;SP;414;180;594;303.030.303.030.303.000;696.969.696.969.696.000
408;ASCURRA;SC;92;40;132;303.030.303.030.303.000;696.969.696.969.696.000
711;BOMBINHAS;SC;184;80;264;303.030.303.030.303.000;696.969.696.969.696.000
707;BOM SUCESSO;PB;46;20;66;303.030.303.030.303.000;696.969.696.969.696.000
4733;S«O JO«O DE IRACEMA;SP;69;30;99;303.030.303.030.303.000;696.969.696.969.696.000
3128;MOGI DAS CRUZES;SP;812;353;1165;303.004.291.845.493.000;696.995.708.154.506.000
3017;MATEUS LEME;MG;352;153;505;302.970.297.029.702.000;697.029.702.970.297.000
1745;EXTREMOZ;RN;237;103;340;302.941.176.470.588.000;697.058.823.529.411.000
264;ANT‚NIO DIAS;MG;214;93;307;302.931.596.091.205.000;697.068.403.908.794.000
3046;MAUêS;AM;359;156;515;302.912.621.359.223.000;697.087.378.640.776.000
1032;CANDIOTA;RS;145;63;208;302.884.615.384.615.000;697.115.384.615.384.000
1507;CUMARU DO NORTE;PA;145;63;208;302.884.615.384.615.000;697.115.384.615.384.000
584;BELêM;AL;99;43;142;302.816.901.408.450.000;697.183.098.591.549.000
1361;CONDE;BA;251;109;360;302.777.777.777.777.000;697.222.222.222.222.000
2234;IPAPORANGA;CE;76;33;109;302.752.293.577.981.000;697.247.706.422.018.000
3714;PEDRA BRANCA;CE;76;33;109;302.752.293.577.981.000;697.247.706.422.018.000
1723;EST∂NCIA VELHA;RS;205;89;294;302.721.088.435.374.000;697.278.911.564.625.000
874;CAETAN‡POLIS;MG;205;89;294;302.721.088.435.374.000;697.278.911.564.625.000
1896;GARÄA;SP;334;145;479;302.713.987.473.903.000;697.286.012.526.096.000
4614;S«O BENEDITO DO RIO PRETO;MA;129;56;185;302.702.702.702.702.000;697.297.297.297.297.000
292;AQUIDAUANA;MS;311;135;446;302.690.582.959.641.000;697.309.417.040.358.000
2063;GURUPI;TO;235;102;337;302.670.623.145.400.000;697.329.376.854.599.000
4364;SALVATERRA;PA;235;102;337;302.670.623.145.400.000;697.329.376.854.599.000
5531;VIÄOSA DO CEARµ;CE;106;46;152;302.631.578.947.368.000;697.368.421.052.631.000
4014;POUSO ALEGRE;MG;544;236;780;302.564.102.564.102.000;697.435.897.435.897.000
1154;CAROLINA;MA;136;59;195;302.564.102.564.102.000;697.435.897.435.897.000
1965;GOVERNADOR VALADARES;MG;800;347;1147;302.528.334.786.399.000;697.471.665.213.600.000
1587;DIVISA ALEGRE;MG;166;72;238;302.521.008.403.361.000;697.478.991.596.638.000
309;ARAÄU;GO;83;36;119;302.521.008.403.361.000;697.478.991.596.638.000
204;AMêRICO DE CAMPOS;SP;83;36;119;302.521.008.403.361.000;697.478.991.596.638.000
3797;PIÄARRA;PA;83;36;119;302.521.008.403.361.000;697.478.991.596.638.000
3387;NOVA RESENDE;MG;166;72;238;302.521.008.403.361.000;697.478.991.596.638.000
1560;DIADEMA;SP;844;366;1210;302.479.338.842.975.000;697.520.661.157.024.000
2671;JURUTI;PA;226;98;324;302.469.135.802.469.000;697.530.864.197.530.000
2489;JACARE÷;SP;482;209;691;302.460.202.604.920.000;697.539.797.395.079.000
5429;URUANA;GO;143;62;205;302.439.024.390.243.000;697.560.975.609.756.000
3503;OURO PRETO;MG;459;199;658;302.431.610.942.249.000;697.568.389.057.750.000
360;ARAUCµRIA;PR;376;163;539;302.411.873.840.445.000;697.588.126.159.554.000
5600;XINGUARA;PA;323;140;463;302.375.809.935.205.000;697.624.190.064.794.000
428;AUGUSTO CORR“A;PA;240;104;344;302.325.581.395.348.000;697.674.418.604.651.000
258;ANTONINA;PR;300;130;430;302.325.581.395.348.000;697.674.418.604.651.000
14;ABREUL∂NDIA;TO;90;39;129;302.325.581.395.348.000;697.674.418.604.651.000
854;CACHOEIRA DOS ÷NDIOS;PB;60;26;86;302.325.581.395.348.000;697.674.418.604.651.000
1547;DELTA;MG;150;65;215;302.325.581.395.348.000;697.674.418.604.651.000
1501;CUITê;PB;90;39;129;302.325.581.395.348.000;697.674.418.604.651.000
1637;DOUTOR SEVERIANO;RN;60;26;86;302.325.581.395.348.000;697.674.418.604.651.000
2106;IBIARA;PB;60;26;86;302.325.581.395.348.000;697.674.418.604.651.000
4498;SANTA ROSA DE GOIµS;GO;120;52;172;302.325.581.395.348.000;697.674.418.604.651.000
2413;ITAPURA;SP;150;65;215;302.325.581.395.348.000;697.674.418.604.651.000
2750;LAMIM;MG;60;26;86;302.325.581.395.348.000;697.674.418.604.651.000
5539;VILA BOA;GO;120;52;172;302.325.581.395.348.000;697.674.418.604.651.000
5424;URANDI;BA;90;39;129;302.325.581.395.348.000;697.674.418.604.651.000
4679;S«O FRANCISCO DE SALES;MG;90;39;129;302.325.581.395.348.000;697.674.418.604.651.000
1672;ENCRUZILHADA;BA;187;81;268;302.238.805.970.149.000;697.761.194.029.850.000
367;AREADO;MG;157;68;225;302.222.222.222.222.000;697.777.777.777.777.000
944;CAMPESTRE;AL;127;55;182;302.197.802.197.802.000;697.802.197.802.197.000
4961;SAPEZAL;MT;127;55;182;302.197.802.197.802.000;697.802.197.802.197.000
649;BOA VISTA DA APARECIDA;PR;97;42;139;302.158.273.381.294.000;697.841.726.618.705.000
1227;CENTRAL;BA;97;42;139;302.158.273.381.294.000;697.841.726.618.705.000
4144;REGENERAÄ«O;PI;97;42;139;302.158.273.381.294.000;697.841.726.618.705.000
3959;PORANGABA;SP;164;71;235;302.127.659.574.468.000;697.872.340.425.531.000
4110;QUIRIN‡POLIS;GO;201;87;288;302.083.333.333.333.000;697.916.666.666.666.000
4905;S«O PEDRO DOS CRENTES;MA;67;29;96;302.083.333.333.333.000;697.916.666.666.666.000
4008;POTê;MG;171;74;245;302.040.816.326.530.000;697.959.183.673.469.000
3245;MURICIL∂NDIA;TO;104;45;149;302.013.422.818.791.000;697.986.577.181.208.000
5347;TUFIL∂NDIA;MA;104;45;149;302.013.422.818.791.000;697.986.577.181.208.000
4859;S«O MATEUS DO MARANH«O;MA;245;106;351;301.994.301.994.301.000;698.005.698.005.698.000
3331;NOVA CRIXµS;GO;141;61;202;301.980.198.019.801.000;698.019.801.980.198.000
5507;VERAN‡POLIS;RS;141;61;202;301.980.198.019.801.000;698.019.801.980.198.000
4228;RIO DAS FLORES;RJ;178;77;255;301.960.784.313.725.000;698.039.215.686.274.000
4156;RESERVA DO CABAÄAL;MT;74;32;106;301.886.792.452.830.000;698.113.207.547.169.000
3013;MATARACA;PB;148;64;212;301.886.792.452.830.000;698.113.207.547.169.000
2359;ITAMOGI;MG;111;48;159;301.886.792.452.830.000;698.113.207.547.169.000
1605;DOM EXPEDITO LOPES;PI;74;32;106;301.886.792.452.830.000;698.113.207.547.169.000
2095;IBARETAMA;CE;111;48;159;301.886.792.452.830.000;698.113.207.547.169.000
720;BONITO;MS;185;80;265;301.886.792.452.830.000;698.113.207.547.169.000
760;BRASILEIRA;PI;74;32;106;301.886.792.452.830.000;698.113.207.547.169.000
368;AREAL;RJ;222;96;318;301.886.792.452.830.000;698.113.207.547.169.000
1067;CAPELA DO ALTO;SP;303;131;434;301.843.317.972.350.000;698.156.682.027.649.000
5568;VIT‡RIA;ES;495;214;709;301.833.568.406.205.000;698.166.431.593.794.000
2427;ITATIAIA;RJ;384;166;550;301.818.181.818.181.000;698.181.818.181.818.000
4580;SANTO ANT‚NIO DO ARACANGUµ;SP;155;67;222;301.801.801.801.801.000;698.198.198.198.198.000
1943;GOIATINS;TO;118;51;169;301.775.147.928.994.000;698.224.852.071.005.000
1703;ESMERALDAS;MG;435;188;623;301.765.650.080.256.000;698.234.349.919.743.000
1980;GRAVATA÷;RS;604;261;865;301.734.104.046.242.000;698.265.895.953.757.000
1662;EL÷SIO MEDRADO;BA;81;35;116;301.724.137.931.034.000;698.275.862.068.965.000
2441;ITAÈNA;MG;544;235;779;301.668.806.161.745.000;698.331.193.838.254.000
2901;M∂NCIO LIMA;AC;176;76;252;301.587.301.587.301.000;698.412.698.412.698.000
3252;NACIP RAYDAN;MG;88;38;126;301.587.301.587.301.000;698.412.698.412.698.000
4043;PRESIDENTE EPITµCIO;SP;308;133;441;301.587.301.587.301.000;698.412.698.412.698.000
657;BOA VISTA DO TUPIM;BA;88;38;126;301.587.301.587.301.000;698.412.698.412.698.000
342;ARAQUARI;SC;176;76;252;301.587.301.587.301.000;698.412.698.412.698.000
5585;WANDERLEY;BA;88;38;126;301.587.301.587.301.000;698.412.698.412.698.000
5546;VILA NOVA DOS MART÷RIOS;MA;132;57;189;301.587.301.587.301.000;698.412.698.412.698.000
5041;SERRA GRANDE;PB;44;19;63;301.587.301.587.301.000;698.412.698.412.698.000
1348;CONCEIÄ«O DO LAGO-AÄU;MA;183;79;262;301.526.717.557.251.000;698.473.282.442.748.000
1319;COL‚MBIA;SP;139;60;199;301.507.537.688.442.000;698.492.462.311.557.000
3179;MONTEIRO;PB;139;60;199;301.507.537.688.442.000;698.492.462.311.557.000
2319;ITAGIMIRIM;BA;190;82;272;301.470.588.235.294.000;698.529.411.764.705.000
3912;POÄ«O DE PEDRAS;MA;95;41;136;301.470.588.235.294.000;698.529.411.764.705.000
2037;GUARARAPES;SP;190;82;272;301.470.588.235.294.000;698.529.411.764.705.000
5042;SERRA NEGRA;SP;248;107;355;301.408.450.704.225.000;698.591.549.295.774.000
1108;CARAÈBAS;RN;102;44;146;301.369.863.013.698.000;698.630.136.986.301.000
4408;SANTA CRUZ DO ARARI;PA;153;66;219;301.369.863.013.698.000;698.630.136.986.301.000
4897;S«O PEDRO DO BUTIµ;RS;51;22;73;301.369.863.013.698.000;698.630.136.986.301.000
308;ARACRUZ;ES;415;179;594;301.346.801.346.801.000;698.653.198.653.198.000
480;BANABUIÈ;CE;160;69;229;301.310.043.668.122.000;698.689.956.331.877.000
3014;MATEIROS;TO;109;47;156;301.282.051.282.051.000;698.717.948.717.948.000
4111;QUISSAM«;RJ;225;97;322;301.242.236.024.844.000;698.757.763.975.155.000
1993;GUA÷RA;SP;283;122;405;301.234.567.901.234.000;698.765.432.098.765.000
2910;MANHUAÄU;MG;399;172;571;301.225.919.439.579.000;698.774.080.560.420.000
2522;JAMBEIRO;SP;174;75;249;301.204.819.277.108.000;698.795.180.722.891.000
3892;PITANGUI;MG;232;100;332;301.204.819.277.108.000;698.795.180.722.891.000
1652;EDêIA;GO;116;50;166;301.204.819.277.108.000;698.795.180.722.891.000
699;BOM LUGAR;MA;116;50;166;301.204.819.277.108.000;698.795.180.722.891.000
639;BOA ESPERANÄA DO IGUAÄU;PR;58;25;83;301.204.819.277.108.000;698.795.180.722.891.000
4838;S«O LOURENÄO DO PIAU÷;PI;58;25;83;301.204.819.277.108.000;698.795.180.722.891.000
858;CACHOEIRA PAULISTA;SP;355;153;508;301.181.102.362.204.000;698.818.897.637.795.000
4185;RIBAS DO RIO PARDO;MS;181;78;259;301.158.301.158.301.000;698.841.698.841.698.000
3520;PAÄO DO LUMIAR;MA;485;209;694;301.152.737.752.161.000;698.847.262.247.838.000
5584;WANDERL∂NDIA;TO;123;53;176;301.136.363.636.363.000;698.863.636.363.636.000
3060;MENDES;RJ;318;137;455;301.098.901.098.901.000;698.901.098.901.098.000
4178;RIACHO DOS MACHADOS;MG;130;56;186;301.075.268.817.204.000;698.924.731.182.795.000
117;ALGOD«O DE JANDA÷RA;PB;65;28;93;301.075.268.817.204.000;698.924.731.182.795.000
223;ANAPU;PA;195;84;279;301.075.268.817.204.000;698.924.731.182.795.000
2024;GUARAMIRIM;SC;195;84;279;301.075.268.817.204.000;698.924.731.182.795.000
2390;ITAPEVI;SP;801;345;1146;301.047.120.418.848.000;698.952.879.581.151.000
4317;RUBIATABA;GO;202;87;289;301.038.062.283.737.000;698.961.937.716.262.000
4698;S«O GONÄALO;RJ;1442;621;2063;301.017.935.046.049.000;698.982.064.953.950.000
4618;S«O BENTO;MA;353;152;505;300.990.099.009.900.000;699.009.900.990.099.000
4611;SANTOS;SP;850;366;1216;300.986.842.105.263.000;699.013.157.894.736.000
4200;RIBEIR«O DOS ÷NDIOS;SP;72;31;103;300.970.873.786.407.000;699.029.126.213.592.000
3814;PIMENTA;MG;144;62;206;300.970.873.786.407.000;699.029.126.213.592.000
3117;MIRAV∂NIA;MG;72;31;103;300.970.873.786.407.000;699.029.126.213.592.000
2972;MARIµPOLIS;SP;72;31;103;300.970.873.786.407.000;699.029.126.213.592.000
2250;IPIRANGA DO PIAU÷;PI;72;31;103;300.970.873.786.407.000;699.029.126.213.592.000
5439;URUCURITUBA;AM;295;127;422;300.947.867.298.578.000;699.052.132.701.421.000
4566;SANTO ANDRê;PB;79;34;113;300.884.955.752.212.000;699.115.044.247.787.000
4875;S«O MIGUEL DO IGUAÄU;PR;158;68;226;300.884.955.752.212.000;699.115.044.247.787.000
508;BARIRI;SP;244;105;349;300.859.598.853.868.000;699.140.401.146.131.000
3820;PINDARê-MIRIM;MA;165;71;236;300.847.457.627.118.000;699.152.542.372.881.000
5431;URUARµ;PA;330;142;472;300.847.457.627.118.000;699.152.542.372.881.000
5456;VALENÄA;RJ;416;179;595;300.840.336.134.453.000;699.159.663.865.546.000
2709;LAGOA DO OURO;PE;86;37;123;300.813.008.130.081.000;699.186.991.869.918.000
167;ALTO SANTO;CE;86;37;123;300.813.008.130.081.000;699.186.991.869.918.000
1791;FERREIRA GOMES;AP;172;74;246;300.813.008.130.081.000;699.186.991.869.918.000
1333;CONCEIÄ«O;PB;86;37;123;300.813.008.130.081.000;699.186.991.869.918.000
4913;S«O ROQUE;SP;523;225;748;300.802.139.037.433.000;699.197.860.962.566.000
2799;LINHARES;ES;544;234;778;300.771.208.226.221.000;699.228.791.773.778.000
2941;MARANH«OZINHO;MA;93;40;133;300.751.879.699.248.000;699.248.120.300.751.000
290;APUIARêS;CE;93;40;133;300.751.879.699.248.000;699.248.120.300.751.000
845;CACHOEIRA;BA;279;120;399;300.751.879.699.248.000;699.248.120.300.751.000
5494;VAZANTE;MG;186;80;266;300.751.879.699.248.000;699.248.120.300.751.000
5407;UMBUZEIRO;PB;93;40;133;300.751.879.699.248.000;699.248.120.300.751.000
1126;CARIRI DO TOCANTINS;TO;100;43;143;300.699.300.699.300.000;699.300.699.300.699.000
1030;C∂NDIDO RODRIGUES;SP;100;43;143;300.699.300.699.300.000;699.300.699.300.699.000
2959;MARECHAL C∂NDIDO RONDON;PR;207;89;296;300.675.675.675.675.000;699.324.324.324.324.000
2392;ITAPIPOCA;CE;321;138;459;300.653.594.771.241.000;699.346.405.228.758.000
4040;PRESIDENTE CASTELO BRANCO;PR;107;46;153;300.653.594.771.241.000;699.346.405.228.758.000
4901;S«O PEDRO DO PIAU÷;PI;107;46;153;300.653.594.771.241.000;699.346.405.228.758.000
4398;SANTA CRUZ CABRµLIA;BA;328;141;469;300.639.658.848.614.000;699.360.341.151.385.000
4354;SALTO DE PIRAPORA;SP;228;98;326;300.613.496.932.515.000;699.386.503.067.484.000
4479;SANTA QUITêRIA DO MARANH«O;MA;114;49;163;300.613.496.932.515.000;699.386.503.067.484.000
5553;VINHEDO;SP;456;196;652;300.613.496.932.515.000;699.386.503.067.484.000
1679;ENGENHEIRO PAULO DE FRONTIN;RJ;242;104;346;300.578.034.682.080.000;699.421.965.317.919.000
2396;ITAPIRAPU«;GO;128;55;183;300.546.448.087.431.000;699.453.551.912.568.000
2174;IGUATU;CE;263;113;376;300.531.914.893.617.000;699.468.085.106.382.000
914;CALDAZINHA;GO;135;58;193;300.518.134.715.025.000;699.481.865.284.974.000
588;BELêM DE S«O FRANCISCO;PE;135;58;193;300.518.134.715.025.000;699.481.865.284.974.000
2388;ITAPEVA;SP;412;177;589;300.509.337.860.780.000;699.490.662.139.219.000
1724;ESTEIO;RS;277;119;396;300.505.050.505.050.000;699.494.949.494.949.000
3868;PIRANHAS;AL;142;61;203;300.492.610.837.438.000;699.507.389.162.561.000
3468;OLIVEIRA;MG;291;125;416;300.480.769.230.769.000;699.519.230.769.230.000
636;BOA ESPERANÄA;ES;149;64;213;300.469.483.568.075.000;699.530.516.431.924.000
1074;CAPIM GROSSO;BA;156;67;223;300.448.430.493.273.000;699.551.569.506.726.000
293;AQUIRAZ;CE;312;134;446;300.448.430.493.273.000;699.551.569.506.726.000
2962;MARECHAL THAUMATURGO;AC;156;67;223;300.448.430.493.273.000;699.551.569.506.726.000
4080;PUXINAN«;PB;163;70;233;300.429.184.549.356.000;699.570.815.450.643.000
2212;INDIARA;GO;163;70;233;300.429.184.549.356.000;699.570.815.450.643.000
4247;RIO GRANDE;RS;687;295;982;300.407.331.975.560.000;699.592.668.024.439.000
3220;MUANµ;PA;184;79;263;300.380.228.136.882.000;699.619.771.863.117.000
822;CAAPIRANGA;AM;191;82;273;300.366.300.366.300.000;699.633.699.633.699.000
5086;SILVES;AM;191;82;273;300.366.300.366.300.000;699.633.699.633.699.000
2302;ITABERA÷;GO;198;85;283;300.353.356.890.459.000;699.646.643.109.540.000
2734;LAJE DO MURIAê;RJ;198;85;283;300.353.356.890.459.000;699.646.643.109.540.000
4245;RIO FORMOSO;PE;198;85;283;300.353.356.890.459.000;699.646.643.109.540.000
4917;S«O SEBASTI«O;AL;198;85;283;300.353.356.890.459.000;699.646.643.109.540.000
3562;PALMEIRAS DE GOIµS;GO;205;88;293;300.341.296.928.327.000;699.658.703.071.672.000
5248;TERRA ALTA;PA;205;88;293;300.341.296.928.327.000;699.658.703.071.672.000
3348;NOVA HARTZ;RS;212;91;303;300.330.033.003.300.000;699.669.966.996.699.000
2133;IBITINGA;SP;431;185;616;300.324.675.324.675.000;699.675.324.675.324.000
4630;S«O BORJA;RS;226;97;323;300.309.597.523.219.000;699.690.402.476.780.000
2382;ITAPEMIRIM;ES;268;115;383;300.261.096.605.744.000;699.738.903.394.255.000
2312;ITACARê;BA;282;121;403;300.248.138.957.816.000;699.751.861.042.183.000
5604;Zê DOCA;MA;282;121;403;300.248.138.957.816.000;699.751.861.042.183.000
2041;GUARATUBA;PR;303;130;433;300.230.946.882.217.000;699.769.053.117.782.000
4638;S«O CARLOS;SP;669;287;956;300.209.205.020.920.000;699.790.794.979.079.000
1790;FERRAZ DE VASCONCELOS;SP;688;295;983;300.101.729.399.796.000;699.898.270.600.203.000
2155;IGARAPAVA;SP;266;114;380;300.000.000.000.000.000;700.000.000.000.000.000
1591;DOIS C‡RREGOS;SP;189;81;270;300.000.000.000.000.000;700.000.000.000.000.000
1448;COUTO DE MAGALH«ES;TO;133;57;190;300.000.000.000.000.000;700.000.000.000.000.000
1444;COTEGIPE;BA;105;45;150;300.000.000.000.000.000;700.000.000.000.000.000
1388;CORBêLIA;PR;98;42;140;300.000.000.000.000.000;700.000.000.000.000.000
1236;CERQUILHO;SP;294;126;420;300.000.000.000.000.000;700.000.000.000.000.000
1214;CAXING‡;PI;70;30;100;300.000.000.000.000.000;700.000.000.000.000.000
810;BURITI DO TOCANTINS;TO;77;33;110;300.000.000.000.000.000;700.000.000.000.000.000
608;BENTO DE ABREU;SP;84;36;120;300.000.000.000.000.000;700.000.000.000.000.000
1100;CARAMBE÷;PR;231;99;330;300.000.000.000.000.000;700.000.000.000.000.000
1012;CANAPI;AL;140;60;200;300.000.000.000.000.000;700.000.000.000.000.000
964;CAMPO ALEGRE DE LOURDES;BA;126;54;180;300.000.000.000.000.000;700.000.000.000.000.000
991;CAMPO NOVO DO PARECIS;MT;161;69;230;300.000.000.000.000.000;700.000.000.000.000.000
184;ALVORADA DO OESTE;RO;161;69;230;300.000.000.000.000.000;700.000.000.000.000.000
78;AGUDOS DO SUL;PR;203;87;290;300.000.000.000.000.000;700.000.000.000.000.000
2293;ISRAEL∂NDIA;GO;70;30;100;300.000.000.000.000.000;700.000.000.000.000.000
2525;JANDAIA;GO;98;42;140;300.000.000.000.000.000;700.000.000.000.000.000
2646;JÈLIO BORGES;PI;63;27;90;300.000.000.000.000.000;700.000.000.000.000.000
3292;NOBRES;MT;154;66;220;300.000.000.000.000.000;700.000.000.000.000.000
3242;MURIBECA;SE;84;36;120;300.000.000.000.000.000;700.000.000.000.000.000
3083;MIMOSO DO SUL;ES;301;129;430;300.000.000.000.000.000;700.000.000.000.000.000
3551;PALMAS DE MONTE ALTO;BA;112;48;160;300.000.000.000.000.000;700.000.000.000.000.000
3521;PACOTI;CE;119;51;170;300.000.000.000.000.000;700.000.000.000.000.000
3460;OLHO D'µGUA GRANDE;AL;77;33;110;300.000.000.000.000.000;700.000.000.000.000.000
3680;PAU D'ARCO;TO;105;45;150;300.000.000.000.000.000;700.000.000.000.000.000
3630;PARAUAPEBAS;PA;525;225;750;300.000.000.000.000.000;700.000.000.000.000.000
3859;PIRAJU;SP;259;111;370;300.000.000.000.000.000;700.000.000.000.000.000
4347;SALITRE;CE;77;33;110;300.000.000.000.000.000;700.000.000.000.000.000
4339;SALGADINHO;PB;49;21;70;300.000.000.000.000.000;700.000.000.000.000.000
4643;S«O DOMINGOS;BA;84;36;120;300.000.000.000.000.000;700.000.000.000.000.000
4645;S«O DOMINGOS;GO;112;48;160;300.000.000.000.000.000;700.000.000.000.000.000
4686;S«O FRANCISCO DO PARµ;PA;154;66;220;300.000.000.000.000.000;700.000.000.000.000.000
4724;S«O JO«O DA PARAÈNA;GO;56;24;80;300.000.000.000.000.000;700.000.000.000.000.000
5201;TAQUARAL DE GOIµS;GO;147;63;210;300.000.000.000.000.000;700.000.000.000.000.000
5427;URU;SP;70;30;100;300.000.000.000.000.000;700.000.000.000.000.000
5337;TRIUNFO;PE;126;54;180;300.000.000.000.000.000;700.000.000.000.000.000
5392;UBERL∂NDIA;MG;1221;523;1744;299.885.321.100.917.000;700.114.678.899.082.000
4575;SANTO ANT‚NIO DE JESUS;BA;320;137;457;299.781.181.619.256.000;700.218.818.380.743.000
4818;S«O JOSê DO RIO PARDO;SP;313;134;447;299.776.286.353.467.000;700.223.713.646.532.000
3423;NOVO HORIZONTE;SP;278;119;397;299.748.110.831.234.000;700.251.889.168.765.000
97;ALC∂NTARA;MA;271;116;387;299.741.602.067.183.000;700.258.397.932.816.000
732;BORBA;AM;271;116;387;299.741.602.067.183.000;700.258.397.932.816.000
1744;EXTREMA;MG;257;110;367;299.727.520.435.967.000;700.272.479.564.032.000
536;BARRA DOS COQUEIROS;SE;243;104;347;299.711.815.561.959.000;700.288.184.438.040.000
5307;TRAIRI;CE;243;104;347;299.711.815.561.959.000;700.288.184.438.040.000
4938;S«O SIM«O;GO;208;89;297;299.663.299.663.299.000;700.336.700.336.700.000
1738;EUCLIDES DA CUNHA PAULISTA;SP;194;83;277;299.638.989.169.675.000;700.361.010.830.324.000
5067;SERT«OZINHO;SP;582;249;831;299.638.989.169.675.000;700.361.010.830.324.000
735;BORDA DA MATA;MG;187;80;267;299.625.468.164.794.000;700.374.531.835.205.000
967;CAMPO BELO;MG;353;151;504;299.603.174.603.174.000;700.396.825.396.825.000
3057;MEDINA;MG;173;74;247;299.595.141.700.404.000;700.404.858.299.595.000
5475;VARGINHA;MG;484;207;691;299.565.846.599.131.000;700.434.153.400.868.000
2804;LOANDA;PR;159;68;227;299.559.471.365.638.000;700.440.528.634.361.000
3930;POMERODE;SC;159;68;227;299.559.471.365.638.000;700.440.528.634.361.000
13;ABREU E LIMA;PE;477;204;681;299.559.471.365.638.000;700.440.528.634.361.000
566;BATALHA;AL;145;62;207;299.516.908.212.560.000;700.483.091.787.439.000
1989;GUA÷BA;RS;435;186;621;299.516.908.212.560.000;700.483.091.787.439.000
1755;FARROUPILHA;RS;283;121;404;299.504.950.495.049.000;700.495.049.504.950.000
1320;COLOMBO;PR;704;301;1005;299.502.487.562.189.000;700.497.512.437.810.000
1464;CRISTAL;RS;138;59;197;299.492.385.786.802.000;700.507.614.213.197.000
297;ARACAJU;SE;800;342;1142;299.474.605.954.465.000;700.525.394.045.534.000
1527;CURRALINHOS;PI;131;56;187;299.465.240.641.711.000;700.534.759.358.288.000
4486;SANTA RITA DE MINAS;MG;131;56;187;299.465.240.641.711.000;700.534.759.358.288.000
3267;NAZARê;BA;255;109;364;299.450.549.450.549.000;700.549.450.549.450.000
2378;ITAPECERICA DA SERRA;SP;496;212;708;299.435.028.248.587.000;700.564.971.751.412.000
3165;MONTE CARLO;SC;117;50;167;299.401.197.604.790.000;700.598.802.395.209.000
4184;RIBAMAR FIQUENE;MA;117;50;167;299.401.197.604.790.000;700.598.802.395.209.000
3970;PORTO;PI;117;50;167;299.401.197.604.790.000;700.598.802.395.209.000
1533;CUST‡DIA;PE;117;50;167;299.401.197.604.790.000;700.598.802.395.209.000
5191;TAPIRA;MG;117;50;167;299.401.197.604.790.000;700.598.802.395.209.000
5091;SIMÂES FILHO;BA;578;247;825;299.393.939.393.939.000;700.606.060.606.060.000
553;BARRO ALTO;GO;110;47;157;299.363.057.324.840.000;700.636.942.675.159.000
3808;PILAR;AL;213;91;304;299.342.105.263.157.000;700.657.894.736.842.000
539;BARRA MANSA;RJ;742;317;1059;299.338.999.055.712.000;700.661.000.944.287.000
317;ARAGUA÷NA;TO;412;176;588;299.319.727.891.156.000;700.680.272.108.843.000
1503;CUITEGI;PB;103;44;147;299.319.727.891.156.000;700.680.272.108.843.000
3876;PIRAQU“;TO;103;44;147;299.319.727.891.156.000;700.680.272.108.843.000
2633;JUAREZ TµVORA;PB;103;44;147;299.319.727.891.156.000;700.680.272.108.843.000
2578;JENIPAPO DOS VIEIRAS;MA;103;44;147;299.319.727.891.156.000;700.680.272.108.843.000
5174;TANGARµ;RN;103;44;147;299.319.727.891.156.000;700.680.272.108.843.000
3910;POµ;SP;604;258;862;299.303.944.315.545.000;700.696.055.684.454.000
1103;CARANGOLA;MG;302;129;431;299.303.944.315.545.000;700.696.055.684.454.000
821;BUTIµ;RS;199;85;284;299.295.774.647.887.000;700.704.225.352.112.000
795;BRUSQUE;SC;398;170;568;299.295.774.647.887.000;700.704.225.352.112.000
562;BARUERI;SP;885;378;1263;299.287.410.926.365.000;700.712.589.073.634.000
3948;PONTE NOVA;MG;384;164;548;299.270.072.992.700.000;700.729.927.007.299.000
3587;PARACATU;MG;384;164;548;299.270.072.992.700.000;700.729.927.007.299.000
3008;MATA DE S«O JO«O;BA;288;123;411;299.270.072.992.700.000;700.729.927.007.299.000
4933;S«O SEBASTI«O DO RIO VERDE;MG;96;41;137;299.270.072.992.700.000;700.729.927.007.299.000
5071;SETE LAGOAS;MG;651;278;929;299.246.501.614.639.000;700.753.498.385.360.000
2725;LAGOA SANTA;MG;370;158;528;299.242.424.242.424.000;700.757.575.757.575.000
5217;TATU÷;SP;459;196;655;299.236.641.221.374.000;700.763.358.778.625.000
3233;MUNDO NOVO;BA;89;38;127;299.212.598.425.196.000;700.787.401.574.803.000
3624;PARAPU«;SP;178;76;254;299.212.598.425.196.000;700.787.401.574.803.000
4050;PRESIDENTE KENNEDY;ES;178;76;254;299.212.598.425.196.000;700.787.401.574.803.000
2599;JOANêSIA;MG;171;73;244;299.180.327.868.852.000;700.819.672.131.147.000
1584;DIVIN‡POLIS;MG;684;292;976;299.180.327.868.852.000;700.819.672.131.147.000
4571;SANTO ANT‚NIO DA PATRULHA;RS;171;73;244;299.180.327.868.852.000;700.819.672.131.147.000
483;BANDEIRA;MG;82;35;117;299.145.299.145.299.000;700.854.700.854.700.000
2395;ITAPIRANGA;SC;82;35;117;299.145.299.145.299.000;700.854.700.854.700.000
5520;VIAM«O;RS;607;259;866;299.076.212.471.131.000;700.923.787.528.868.000
2651;JUNCO DO SERID‡;PB;75;32;107;299.065.420.560.747.000;700.934.579.439.252.000
4219;RIO BRANCO DO IVA÷;PR;75;32;107;299.065.420.560.747.000;700.934.579.439.252.000
355;ARATACA;BA;150;64;214;299.065.420.560.747.000;700.934.579.439.252.000
2424;ITARIRI;SP;218;93;311;299.035.369.774.919.000;700.964.630.225.080.000
1760;FµTIMA DO SUL;MS;143;61;204;299.019.607.843.137.000;700.980.392.156.862.000
2419;ITAQUITINGA;PE;211;90;301;299.003.322.259.136.000;700.996.677.740.863.000
2309;ITACAJµ;TO;68;29;97;298.969.072.164.948.000;701.030.927.835.051.000
2436;ITAÈ DE MINAS;MG;204;87;291;298.969.072.164.948.000;701.030.927.835.051.000
3172;MONTE HOREBE;PB;68;29;97;298.969.072.164.948.000;701.030.927.835.051.000
4152;RERIUTABA;CE;68;29;97;298.969.072.164.948.000;701.030.927.835.051.000
4400;SANTA CRUZ DA CONCEIÄ«O;SP;136;58;194;298.969.072.164.948.000;701.030.927.835.051.000
3434;NOVO ORIENTE DO PIAU÷;PI;68;29;97;298.969.072.164.948.000;701.030.927.835.051.000
3501;OURO BRANCO;RN;68;29;97;298.969.072.164.948.000;701.030.927.835.051.000
1395;COREAÈ;CE;68;29;97;298.969.072.164.948.000;701.030.927.835.051.000
1071;CAPETINGA;MG;136;58;194;298.969.072.164.948.000;701.030.927.835.051.000
4826;S«O JOSê DOS BAS÷LIOS;MA;68;29;97;298.969.072.164.948.000;701.030.927.835.051.000
1639;DOVERL∂NDIA;GO;129;55;184;298.913.043.478.260.000;701.086.956.521.739.000
2281;IRAPURU;SP;129;55;184;298.913.043.478.260.000;701.086.956.521.739.000
3851;PIRACAIA;SP;258;110;368;298.913.043.478.260.000;701.086.956.521.739.000
4084;QUARTO CENTENµRIO;PR;129;55;184;298.913.043.478.260.000;701.086.956.521.739.000
5152;TACAIMB‡;PE;129;55;184;298.913.043.478.260.000;701.086.956.521.739.000
1017;CANAS;SP;190;81;271;298.892.988.929.889.000;701.107.011.070.110.000
4307;ROSµRIO;MA;312;133;445;298.876.404.494.382.000;701.123.595.505.617.000
2742;LAJEDO;PE;122;52;174;298.850.574.712.643.000;701.149.425.287.356.000
890;CAIÄARA;PB;61;26;87;298.850.574.712.643.000;701.149.425.287.356.000
776;BREJO DE AREIA;MA;61;26;87;298.850.574.712.643.000;701.149.425.287.356.000
1881;FRUTUOSO GOMES;RN;61;26;87;298.850.574.712.643.000;701.149.425.287.356.000
5166;TALISM«;TO;122;52;174;298.850.574.712.643.000;701.149.425.287.356.000
5144;TABATINGA;AM;352;150;502;298.804.780.876.494.000;701.195.219.123.505.000
1458;CRICIÈMA;SC;345;147;492;298.780.487.804.878.000;701.219.512.195.121.000
4026;PRAIA GRANDE;SP;629;268;897;298.773.690.078.037.000;701.226.309.921.962.000
5160;TAIL∂NDIA;PA;338;144;482;298.755.186.721.991.000;701.244.813.278.008.000
3724;PEDRALVA;MG;223;95;318;298.742.138.364.779.000;701.257.861.635.220.000
1722;EST∂NCIA;SE;277;118;395;298.734.177.215.189.000;701.265.822.784.810.000
1208;CAUCAIA;CE;709;302;1011;298.714.144.411.473.000;701.285.855.588.526.000
2496;JACOBINA DO PIAU÷;PI;54;23;77;298.701.298.701.298.000;701.298.701.298.701.000
1821;FLORIANO;PI;317;135;452;298.672.566.371.681.000;701.327.433.628.318.000
3755;PELOTAS;RS;674;287;961;298.647.242.455.775.000;701.352.757.544.224.000
1549;DENISE;MT;101;43;144;298.611.111.111.111.000;701.388.888.888.888.000
4795;S«O JOSê DO BELMONTE;PE;101;43;144;298.611.111.111.111.000;701.388.888.888.888.000
5500;VERA;MT;101;43;144;298.611.111.111.111.000;701.388.888.888.888.000
2553;JARDIM ALEGRE;PR;148;63;211;298.578.199.052.132.000;701.421.800.947.867.000
4044;PRESIDENTE FIGUEIREDO;AM;242;103;345;298.550.724.637.681.000;701.449.275.362.318.000
4087;QUATIPURU;PA;188;80;268;298.507.462.686.567.000;701.492.537.313.432.000
3973;PORTO ALEGRE DO NORTE;MT;141;60;201;298.507.462.686.567.000;701.492.537.313.432.000
2513;JAGUARIBARA;CE;94;40;134;298.507.462.686.567.000;701.492.537.313.432.000
1780;FELIZ DESERTO;AL;94;40;134;298.507.462.686.567.000;701.492.537.313.432.000
414;ASSIS CHATEAUBRIAND;PR;188;80;268;298.507.462.686.567.000;701.492.537.313.432.000
4732;S«O JO«O DAS MISSÂES;MG;94;40;134;298.507.462.686.567.000;701.492.537.313.432.000
4685;S«O FRANCISCO DO OESTE;RN;47;20;67;298.507.462.686.567.000;701.492.537.313.432.000
3122;MOCAJUBA;PA;181;77;258;298.449.612.403.100.000;701.550.387.596.899.000
3588;PARACURU;CE;268;114;382;298.429.319.371.727.000;701.570.680.628.272.000
4628;S«O BERNARDO DO CAMPO;SP;1312;558;1870;298.395.721.925.133.000;701.604.278.074.866.000
4169;RIACH«O DO POÄO;PB;87;37;124;298.387.096.774.193.000;701.612.903.225.806.000
3079;MILAGRES DO MARANH«O;MA;87;37;124;298.387.096.774.193.000;701.612.903.225.806.000
493;BAR«O DE COCAIS;MG;301;128;429;298.368.298.368.298.000;701.631.701.631.701.000
38;AFONSO CUNHA;MA;127;54;181;298.342.541.436.464.000;701.657.458.563.535.000
266;ANT‚NIO JO«O;MS;127;54;181;298.342.541.436.464.000;701.657.458.563.535.000
3767;PERDIZES;MG;127;54;181;298.342.541.436.464.000;701.657.458.563.535.000
5069;SETE BARRAS;SP;254;108;362;298.342.541.436.464.000;701.657.458.563.535.000
2846;MACAPµ;AP;668;284;952;298.319.327.731.092.000;701.680.672.268.907.000
611;BEQUIM«O;MA;207;88;295;298.305.084.745.762.000;701.694.915.254.237.000
900;CAJATI;SP;207;88;295;298.305.084.745.762.000;701.694.915.254.237.000
2824;LU÷S EDUARDO MAGALH«ES;BA;447;190;637;298.273.155.416.012.000;701.726.844.583.987.000
2573;JAÈ DO TOCANTINS;TO;80;34;114;298.245.614.035.087.000;701.754.385.964.912.000
3108;MIRANGABA;BA;120;51;171;298.245.614.035.087.000;701.754.385.964.912.000
4118;QUIXEL‚;CE;120;51;171;298.245.614.035.087.000;701.754.385.964.912.000
930;CAMBARµ;PR;160;68;228;298.245.614.035.087.000;701.754.385.964.912.000
1176;CµSSIA DOS COQUEIROS;SP;120;51;171;298.245.614.035.087.000;701.754.385.964.912.000
5325;TR“S PASSOS;RS;120;51;171;298.245.614.035.087.000;701.754.385.964.912.000
999;CAMPOS DOS GOYTACAZES;RJ;1113;473;1586;298.234.552.332.912.000;701.765.447.667.087.000
124;ALMENARA;MG;313;133;446;298.206.278.026.905.000;701.793.721.973.094.000
2654;JUNDIA÷;SP;819;348;1167;298.200.514.138.817.000;701.799.485.861.182.000
46;µGUA BOA;MT;153;65;218;298.165.137.614.678.000;701.834.862.385.321.000
447;AXIXµ DO TOCANTINS;TO;113;48;161;298.136.645.962.732.000;701.863.354.037.267.000
2091;IARAS;SP;113;48;161;298.136.645.962.732.000;701.863.354.037.267.000
2317;ITAGI;BA;113;48;161;298.136.645.962.732.000;701.863.354.037.267.000
3241;MURIAê;MG;452;192;644;298.136.645.962.732.000;701.863.354.037.267.000
805;BURITAMA;SP;186;79;265;298.113.207.547.169.000;701.886.792.452.830.000
5316;TR“S CACHOEIRAS;RS;73;31;104;298.076.923.076.923.000;701.923.076.923.076.000
5445;URUSSANGA;SC;146;62;208;298.076.923.076.923.000;701.923.076.923.076.000
4910;S«O RAIMUNDO NONATO;PI;146;62;208;298.076.923.076.923.000;701.923.076.923.076.000
3419;NOVO GAMA;GO;464;197;661;298.033.282.904.689.000;701.966.717.095.310.000
3375;NOVA OLINDA DO MARANH«O;MA;106;45;151;298.013.245.033.112.000;701.986.754.966.887.000
3183;MONTES ALTOS;MA;106;45;151;298.013.245.033.112.000;701.986.754.966.887.000
4460;SANTA MARIA;RS;424;180;604;298.013.245.033.112.000;701.986.754.966.887.000
3913;POCINHOS;PB;106;45;151;298.013.245.033.112.000;701.986.754.966.887.000
7;ABARê;BA;106;45;151;298.013.245.033.112.000;701.986.754.966.887.000
2143;ICARA÷MA;PR;106;45;151;298.013.245.033.112.000;701.986.754.966.887.000
1504;CUJUBIM;RO;212;90;302;298.013.245.033.112.000;701.986.754.966.887.000
1379;CONTAGEM;MG;1112;472;1584;297.979.797.979.797.000;702.020.202.020.202.000
5119;SOMBRIO;SC;139;59;198;297.979.797.979.797.000;702.020.202.020.202.000
1066;CAPELA DE SANTANA;RS;172;73;245;297.959.183.673.469.000;702.040.816.326.530.000
2313;ITACOATIARA;AM;443;188;631;297.939.778.129.952.000;702.060.221.870.047.000
4765;S«O JOAQUIM DA BARRA;SP;238;101;339;297.935.103.244.837.000;702.064.896.755.162.000
3421;NOVO HORIZONTE;SC;66;28;94;297.872.340.425.531.000;702.127.659.574.468.000
3411;NOVO ACORDO;TO;99;42;141;297.872.340.425.531.000;702.127.659.574.468.000
3341;NOVA FµTIMA;BA;66;28;94;297.872.340.425.531.000;702.127.659.574.468.000
3739;PEDRO AVELINO;RN;99;42;141;297.872.340.425.531.000;702.127.659.574.468.000
4129;RANCHO QUEIMADO;SC;66;28;94;297.872.340.425.531.000;702.127.659.574.468.000
1063;CAPARA‡;MG;132;56;188;297.872.340.425.531.000;702.127.659.574.468.000
2061;GURJ«O;PB;66;28;94;297.872.340.425.531.000;702.127.659.574.468.000
1787;FERNANDO PRESTES;SP;66;28;94;297.872.340.425.531.000;702.127.659.574.468.000
1801;FIRMINO ALVES;BA;66;28;94;297.872.340.425.531.000;702.127.659.574.468.000
530;BARRA DO PIRA÷;RJ;587;249;836;297.846.889.952.153.000;702.153.110.047.846.000
222;ANµPOLIS;GO;995;422;1417;297.812.279.463.655.000;702.187.720.536.344.000
2452;ITOROR‡;BA;158;67;225;297.777.777.777.777.000;702.222.222.222.222.000
803;BUJARU;PA;283;120;403;297.766.749.379.652.000;702.233.250.620.347.000
1438;CORUPµ;SC;125;53;178;297.752.808.988.764.000;702.247.191.011.235.000
2504;JAGUAPIT«;PR;125;53;178;297.752.808.988.764.000;702.247.191.011.235.000
4942;S«O TOMµS DE AQUINO;MG;125;53;178;297.752.808.988.764.000;702.247.191.011.235.000
5177;TANGUµ;RJ;375;159;534;297.752.808.988.764.000;702.247.191.011.235.000
5578;VOLTA GRANDE;MG;125;53;178;297.752.808.988.764.000;702.247.191.011.235.000
5003;SENADOR GUIOMARD;AC;217;92;309;297.734.627.831.715.000;702.265.372.168.284.000
2791;LIMOEIRO DE ANADIA;AL;92;39;131;297.709.923.664.122.000;702.290.076.335.877.000
3250;MUTUN‡POLIS;GO;92;39;131;297.709.923.664.122.000;702.290.076.335.877.000
1773;FEIRA NOVA;SE;92;39;131;297.709.923.664.122.000;702.290.076.335.877.000
2053;GUIA LOPES DA LAGUNA;MS;92;39;131;297.709.923.664.122.000;702.290.076.335.877.000
5603;ZACARIAS;SP;92;39;131;297.709.923.664.122.000;702.290.076.335.877.000
5163;TAIPAS DO TOCANTINS;TO;92;39;131;297.709.923.664.122.000;702.290.076.335.877.000
3697;PAULO DE FARIA;SP;151;64;215;297.674.418.604.651.000;702.325.581.395.348.000
3504;OURO PRETO DO OESTE;RO;210;89;299;297.658.862.876.254.000;702.341.137.123.745.000
3689;PAULINO NEVES;MA;118;50;168;297.619.047.619.047.000;702.380.952.380.952.000
4053;PRESIDENTE MêDICI;MA;118;50;168;297.619.047.619.047.000;702.380.952.380.952.000
640;BOA ESPERANÄA DO SUL;SP;177;75;252;297.619.047.619.047.000;702.380.952.380.952.000
1000;CAMPOS GERAIS;MG;177;75;252;297.619.047.619.047.000;702.380.952.380.952.000
344;ARARANGUµ;SC;236;100;336;297.619.047.619.047.000;702.380.952.380.952.000
4660;S«O FêLIX DE BALSAS;MA;59;25;84;297.619.047.619.047.000;702.380.952.380.952.000
1440;COSM‡POLIS;SP;439;186;625;297.600.000.000.000.000;702.400.000.000.000.000
693;BOM JESUS DO NORTE;ES;203;86;289;297.577.854.671.280.000;702.422.145.328.719.000
1304;COD‡;MA;347;147;494;297.570.850.202.429.000;702.429.149.797.570.000
5036;SERRA DO NAVIO;AP;144;61;205;297.560.975.609.756.000;702.439.024.390.243.000
2379;ITAPECURU MIRIM;MA;399;169;568;297.535.211.267.605.000;702.464.788.732.394.000
3255;N«O-ME-TOQUE;RS;85;36;121;297.520.661.157.024.000;702.479.338.842.975.000
4504;SANTA ROSA DO SUL;SC;85;36;121;297.520.661.157.024.000;702.479.338.842.975.000
1087;CAPIVARI;SP;255;108;363;297.520.661.157.024.000;702.479.338.842.975.000
491;BAR«O;RS;85;36;121;297.520.661.157.024.000;702.479.338.842.975.000
4975;SµTIRO DIAS;BA;85;36;121;297.520.661.157.024.000;702.479.338.842.975.000
2448;ITIRAPU«;SP;196;83;279;297.491.039.426.523.000;702.508.960.573.476.000
988;CAMPO MOUR«O;PR;307;130;437;297.482.837.528.604.000;702.517.162.471.395.000
1423;C‡RREGO DO BOM JESUS;MG;111;47;158;297.468.354.430.379.000;702.531.645.569.620.000
4285;RODEIRO;MG;111;47;158;297.468.354.430.379.000;702.531.645.569.620.000
4481;SANTA RITA;PB;489;207;696;297.413.793.103.448.000;702.586.206.896.551.000
3731;PEDREGULHO;SP;215;91;306;297.385.620.915.032.000;702.614.379.084.967.000
2399;ITAPISSUMA;PE;215;91;306;297.385.620.915.032.000;702.614.379.084.967.000
4002;PORTO VELHO;RO;879;372;1251;297.362.110.311.750.000;702.637.889.688.249.000
3899;PLANALTINA;GO;676;286;962;297.297.297.297.297.000;702.702.702.702.702.000
717;BONINAL;BA;130;55;185;297.297.297.297.297.000;702.702.702.702.702.000
267;ANT‚NIO MARTINS;RN;52;22;74;297.297.297.297.297.000;702.702.702.702.702.000
129;ALPERCATA;MG;208;88;296;297.297.297.297.297.000;702.702.702.702.702.000
100;ALCIN‡POLIS;MS;104;44;148;297.297.297.297.297.000;702.702.702.702.702.000
5245;TERES‡POLIS;RJ;520;220;740;297.297.297.297.297.000;702.702.702.702.702.000
4707;S«O GONÄALO DO SAPUCA÷;MG;279;118;397;297.229.219.143.576.000;702.770.780.856.423.000
4405;SANTA CRUZ DE MINAS;MG;201;85;286;297.202.797.202.797.000;702.797.202.797.202.000
3956;PONTO NOVO;BA;149;63;212;297.169.811.320.754.000;702.830.188.679.245.000
4736;S«O JO«O DEL REI;MG;421;178;599;297.161.936.560.934.000;702.838.063.439.065.000
878;CAETITê;BA;123;52;175;297.142.857.142.857.000;702.857.142.857.142.000
740;BOTUCATU;SP;343;145;488;297.131.147.540.983.000;702.868.852.459.016.000
865;CACIMBA DE DENTRO;PB;97;41;138;297.101.449.275.362.000;702.898.550.724.637.000
992;CAMPO REDONDO;RN;97;41;138;297.101.449.275.362.000;702.898.550.724.637.000
2019;GUARACIABA DO NORTE;CE;97;41;138;297.101.449.275.362.000;702.898.550.724.637.000
2255;IPORµ;GO;194;82;276;297.101.449.275.362.000;702.898.550.724.637.000
2479;JABORANDI;BA;97;41;138;297.101.449.275.362.000;702.898.550.724.637.000
284;APODI;RN;168;71;239;297.071.129.707.112.000;702.928.870.292.887.000
214;ANAGê;BA;142;60;202;297.029.702.970.297.000;702.970.297.029.702.000
777;BREJO DO CRUZ;PB;71;30;101;297.029.702.970.297.000;702.970.297.029.702.000
1828;FONTOURA XAVIER;RS;71;30;101;297.029.702.970.297.000;702.970.297.029.702.000
2455;ITUBERµ;BA;213;90;303;297.029.702.970.297.000;702.970.297.029.702.000
4042;PRESIDENTE DUTRA;BA;71;30;101;297.029.702.970.297.000;702.970.297.029.702.000
4177;RIACHO DOS CAVALOS;PB;71;30;101;297.029.702.970.297.000;702.970.297.029.702.000
1532;CURVELO;MG;400;169;569;297.012.302.284.710.000;702.987.697.715.289.000
789;BRODOWSKI;SP;258;109;367;297.002.724.795.640.000;702.997.275.204.359.000
3219;MOZARL∂NDIA;GO;116;49;165;296.969.696.969.696.000;703.030.303.030.303.000
5049;SERRANIA;MG;116;49;165;296.969.696.969.696.000;703.030.303.030.303.000
4248;RIO GRANDE DA SERRA;SP;341;144;485;296.907.216.494.845.000;703.092.783.505.154.000
3264;NATUBA;PB;90;38;128;296.875.000.000.000.000;703.125.000.000.000.000
2423;ITAREMA;CE;180;76;256;296.875.000.000.000.000;703.125.000.000.000.000
2650;JUNCO DO MARANH«O;MA;90;38;128;296.875.000.000.000.000;703.125.000.000.000.000
1520;CURRAIS;PI;135;57;192;296.875.000.000.000.000;703.125.000.000.000.000
1669;EMILIAN‡POLIS;SP;90;38;128;296.875.000.000.000.000;703.125.000.000.000.000
2260;IPU«;SP;135;57;192;296.875.000.000.000.000;703.125.000.000.000.000
4998;SENADOR CANEDO;GO;360;152;512;296.875.000.000.000.000;703.125.000.000.000.000
4944;S«O TOMê;RN;90;38;128;296.875.000.000.000.000;703.125.000.000.000.000
4657;S«O FELIPE;BA;135;57;192;296.875.000.000.000.000;703.125.000.000.000.000
5573;VIT‡RIA DO JARI;AP;225;95;320;296.875.000.000.000.000;703.125.000.000.000.000
4126;RANCHARIA;SP;244;103;347;296.829.971.181.556.000;703.170.028.818.443.000
2;ABADI∂NIA;GO;154;65;219;296.803.652.968.036.000;703.196.347.031.963.000
5336;TRIUNFO;RS;154;65;219;296.803.652.968.036.000;703.196.347.031.963.000
4716;S«O JO«O BATISTA DO GL‡RIA;MG;154;65;219;296.803.652.968.036.000;703.196.347.031.963.000
5012;SENGêS;PR;154;65;219;296.803.652.968.036.000;703.196.347.031.963.000
5435;URUCARµ;AM;263;111;374;296.791.443.850.267.000;703.208.556.149.732.000
1366;CONFRESA;MT;218;92;310;296.774.193.548.387.000;703.225.806.451.612.000
1567;DIAN‡POLIS;TO;173;73;246;296.747.967.479.674.000;703.252.032.520.325.000
3420;NOVO HAMBURGO;RS;410;173;583;296.740.994.854.202.000;703.259.005.145.797.000
834;CABO FRIO;RJ;711;300;1011;296.735.905.044.510.000;703.264.094.955.489.000
1513;CUPIRA;PE;128;54;182;296.703.296.703.296.000;703.296.703.296.703.000
4322;RUY BARBOSA;BA;128;54;182;296.703.296.703.296.000;703.296.703.296.703.000
4295;RONCADOR;PR;128;54;182;296.703.296.703.296.000;703.296.703.296.703.000
5080;SILVA JARDIM;RJ;256;108;364;296.703.296.703.296.000;703.296.703.296.703.000
66;µGUAS DA PRATA;SP;147;62;209;296.650.717.703.349.000;703.349.282.296.650.000
1139;CARMO DO CAJURU;MG;230;97;327;296.636.085.626.911.000;703.363.914.373.088.000
3487;OSASCO;SP;1022;431;1453;296.627.666.896.077.000;703.372.333.103.922.000
54;µGUA DOCE;SC;83;35;118;296.610.169.491.525.000;703.389.830.508.474.000
1564;DIAMANTE D'OESTE;PR;83;35;118;296.610.169.491.525.000;703.389.830.508.474.000
1661;ELISIµRIO;SP;83;35;118;296.610.169.491.525.000;703.389.830.508.474.000
1602;DOM BOSCO;MG;83;35;118;296.610.169.491.525.000;703.389.830.508.474.000
5222;TEFê;AM;332;140;472;296.610.169.491.525.000;703.389.830.508.474.000
839;CAÄADOR;SC;268;113;381;296.587.926.509.186.000;703.412.073.490.813.000
3481;ORL∂NDIA;SP;185;78;263;296.577.946.768.060.000;703.422.053.231.939.000
2818;LUCIARA;MT;102;43;145;296.551.724.137.931.000;703.448.275.862.068.000
1512;CUPARAQUE;MG;102;43;145;296.551.724.137.931.000;703.448.275.862.068.000
4764;S«O JOAQUIM;SC;102;43;145;296.551.724.137.931.000;703.448.275.862.068.000
2013;GUARABIRA;PB;223;94;317;296.529.968.454.258.000;703.470.031.545.741.000
3648;PAROBê;RS;344;145;489;296.523.517.382.413.000;703.476.482.617.586.000
3944;PONTE ALTA DO BOM JESUS;TO;121;51;172;296.511.627.906.976.000;703.488.372.093.023.000
2153;IGARAÄU DO TIET“;SP;261;110;371;296.495.956.873.315.000;703.504.043.126.684.000
5434;URUC∂NIA;MG;159;67;226;296.460.176.991.150.000;703.539.823.008.849.000
3833;PINHALZINHO;SP;197;83;280;296.428.571.428.571.000;703.571.428.571.428.000
5251;TERRA NOVA;BA;197;83;280;296.428.571.428.571.000;703.571.428.571.428.000
2240;IPER‡;SP;273;115;388;296.391.752.577.319.000;703.608.247.422.680.000
1871;FREI LAGONEGRO;MG;76;32;108;296.296.296.296.296.000;703.703.703.703.703.000
824;CAARAP‡;MS;114;48;162;296.296.296.296.296.000;703.703.703.703.703.000
934;CAMBORIÈ;SC;304;128;432;296.296.296.296.296.000;703.703.703.703.703.000
3773;PERIQUITO;MG;152;64;216;296.296.296.296.296.000;703.703.703.703.703.000
4439;SANTA ISABEL DO IVA÷;PR;114;48;162;296.296.296.296.296.000;703.703.703.703.703.000
4259;RIO NOVO DO SUL;ES;133;56;189;296.296.296.296.296.000;703.703.703.703.703.000
4181;RIACHUELO;SE;114;48;162;296.296.296.296.296.000;703.703.703.703.703.000
3371;NOVA OL÷MPIA;PR;76;32;108;296.296.296.296.296.000;703.703.703.703.703.000
5415;UNI«O DE MINAS;MG;76;32;108;296.296.296.296.296.000;703.703.703.703.703.000
5088;SIM«O DIAS;SE;190;80;270;296.296.296.296.296.000;703.703.703.703.703.000
1456;CRAVINHOS;SP;278;117;395;296.202.531.645.569.000;703.797.468.354.430.000
324;ARAIOSES;MA;221;93;314;296.178.343.949.044.000;703.821.656.050.955.000
1432;CORUMBµ;MS;423;178;601;296.173.044.925.124.000;703.826.955.074.875.000
405;ARUJµ;SP;404;170;574;296.167.247.386.759.000;703.832.752.613.240.000
1369;CONGONHAS;MG;366;154;520;296.153.846.153.846.000;703.846.153.846.153.000
3238;MUNIZ FREIRE;ES;183;77;260;296.153.846.153.846.000;703.846.153.846.153.000
2802;LIVRAMENTO DE NOSSA SENHORA;BA;183;77;260;296.153.846.153.846.000;703.846.153.846.153.000
3961;PORCIÈNCULA;RJ;183;77;260;296.153.846.153.846.000;703.846.153.846.153.000
913;CALDAS NOVAS;GO;347;146;493;296.146.044.624.746.000;703.853.955.375.253.000
1590;DOBRADA;SP;145;61;206;296.116.504.854.368.000;703.883.495.145.631.000
3760;PENEDO;AL;252;106;358;296.089.385.474.860.000;703.910.614.525.139.000
2535;JAPARATINGA;AL;126;53;179;296.089.385.474.860.000;703.910.614.525.139.000
3368;NOVA NAZARê;MT;126;53;179;296.089.385.474.860.000;703.910.614.525.139.000
2922;MAR DE ESPANHA;MG;107;45;152;296.052.631.578.947.000;703.947.368.421.052.000
3744;PEDRO II;PI;107;45;152;296.052.631.578.947.000;703.947.368.421.052.000
4639;S«O CARLOS DO IVA÷;PR;107;45;152;296.052.631.578.947.000;703.947.368.421.052.000
4365;SAMBA÷BA;MA;88;37;125;296.000.000.000.000.000;704.000.000.000.000.000
1049;CANTAGALO;PR;176;74;250;296.000.000.000.000.000;704.000.000.000.000.000
786;BREVES;PA;333;140;473;295.983.086.680.761.000;704.016.913.319.238.000
1451;COXIM;MS;226;95;321;295.950.155.763.239.000;704.049.844.236.760.000
4962;SAPIRANGA;RS;295;124;419;295.942.720.763.723.000;704.057.279.236.276.000
2840;MACAê;RJ;502;211;713;295.932.678.821.879.000;704.067.321.178.120.000
3392;NOVA SANTA BµRBARA;PR;69;29;98;295.918.367.346.938.000;704.081.632.653.061.000
1536;DAMI«O;PB;69;29;98;295.918.367.346.938.000;704.081.632.653.061.000
1358;CONDADO;PB;69;29;98;295.918.367.346.938.000;704.081.632.653.061.000
2162;IGARATµ;SP;138;58;196;295.918.367.346.938.000;704.081.632.653.061.000
958;CAMPINAS DO PIAU÷;PI;69;29;98;295.918.367.346.938.000;704.081.632.653.061.000
785;BREU BRANCO;PA;257;108;365;295.890.410.958.904.000;704.109.589.041.095.000
3072;MIGUEL ALVES;PI;188;79;267;295.880.149.812.734.000;704.119.850.187.265.000
2608;JO«O NEIVA;ES;188;79;267;295.880.149.812.734.000;704.119.850.187.265.000
2415;ITAQUAQUECETUBA;SP;957;402;1359;295.805.739.514.348.000;704.194.260.485.651.000
2664;JUREMA;PI;50;21;71;295.774.647.887.323.000;704.225.352.112.676.000
3228;MULITERNO;RS;50;21;71;295.774.647.887.323.000;704.225.352.112.676.000
4422;SANTA Fê DO SUL;SP;200;84;284;295.774.647.887.323.000;704.225.352.112.676.000
800;BUGRE;MG;100;42;142;295.774.647.887.323.000;704.225.352.112.676.000
80;AGUIAR;PB;50;21;71;295.774.647.887.323.000;704.225.352.112.676.000
286;APORê;GO;100;42;142;295.774.647.887.323.000;704.225.352.112.676.000
2253;IPIXUNA DO PARµ;PA;250;105;355;295.774.647.887.323.000;704.225.352.112.676.000
5045;SERRA PRETA;BA;150;63;213;295.774.647.887.323.000;704.225.352.112.676.000
4802;S«O JOSê DO DIVINO;PI;50;21;71;295.774.647.887.323.000;704.225.352.112.676.000
5388;UBARANA;SP;150;63;213;295.774.647.887.323.000;704.225.352.112.676.000
5254;TERRA RICA;PR;100;42;142;295.774.647.887.323.000;704.225.352.112.676.000
982;CAMPO LARGO;PR;381;160;541;295.748.613.678.373.000;704.251.386.321.626.000
2787;LIMA DUARTE;MG;231;97;328;295.731.707.317.073.000;704.268.292.682.926.000
3999;PORTO RICO DO MARANH«O;MA;131;55;186;295.698.924.731.182.000;704.301.075.268.817.000
5195;TAPIRAMUTµ;BA;131;55;186;295.698.924.731.182.000;704.301.075.268.817.000
4440;SANTA ISABEL DO PARµ;PA;374;157;531;295.668.549.905.838.000;704.331.450.094.161.000
4391;SANTA CEC÷LIA DO PAV«O;PR;81;34;115;295.652.173.913.043.000;704.347.826.086.956.000
3568;PALMITAL;SP;162;68;230;295.652.173.913.043.000;704.347.826.086.956.000
3000;MARUMBI;PR;81;34;115;295.652.173.913.043.000;704.347.826.086.956.000
1118;CAREIRO;AM;405;170;575;295.652.173.913.043.000;704.347.826.086.956.000
215;ANAHY;PR;81;34;115;295.652.173.913.043.000;704.347.826.086.956.000
1240;CERRO CORµ;RN;81;34;115;295.652.173.913.043.000;704.347.826.086.956.000
5138;SUSSUAPARA;PI;81;34;115;295.652.173.913.043.000;704.347.826.086.956.000
5224;TEIXEIRA DE FREITAS;BA;548;230;778;295.629.820.051.413.000;704.370.179.948.586.000
4666;S«O FêLIX DO XINGU;PA;305;128;433;295.612.009.237.875.000;704.387.990.762.124.000
1397;CORGUINHO;MS;112;47;159;295.597.484.276.729.000;704.402.515.723.270.000
2216;INGA÷;MG;112;47;159;295.597.484.276.729.000;704.402.515.723.270.000
3253;NANTES;SP;112;47;159;295.597.484.276.729.000;704.402.515.723.270.000
2387;ITAPETININGA;SP;448;188;636;295.597.484.276.729.000;704.402.515.723.270.000
1987;GUAÄU÷;ES;255;107;362;295.580.110.497.237.000;704.419.889.502.762.000
3965;PORTEIR«O;GO;143;60;203;295.566.502.463.054.000;704.433.497.536.945.000
4001;PORTO UNI«O;SC;205;86;291;295.532.646.048.109.000;704.467.353.951.890.000
2363;ITANHANDU;MG;236;99;335;295.522.388.059.701.000;704.477.611.940.298.000
465;BAIXO GUANDU;ES;298;125;423;295.508.274.231.678.000;704.491.725.768.321.000
927;CAMAQU«;RS;298;125;423;295.508.274.231.678.000;704.491.725.768.321.000
4692;S«O GABRIEL DA PALHA;ES;298;125;423;295.508.274.231.678.000;704.491.725.768.321.000
79;µGUIA BRANCA;ES;124;52;176;295.454.545.454.545.000;704.545.454.545.454.000
1541;DAVID CANABARRO;RS;62;26;88;295.454.545.454.545.000;704.545.454.545.454.000
2511;JAGUARI;RS;93;39;132;295.454.545.454.545.000;704.545.454.545.454.000
2918;MANSID«O;BA;93;39;132;295.454.545.454.545.000;704.545.454.545.454.000
3792;PIANC‡;PB;93;39;132;295.454.545.454.545.000;704.545.454.545.454.000
5176;TANGARµ DA SERRA;MT;341;143;484;295.454.545.454.545.000;704.545.454.545.454.000
1374;CONSELHEIRO LAFAIETE;MG;446;187;633;295.418.641.390.205.000;704.581.358.609.794.000
5379;TUT‡IA;MA;291;122;413;295.399.515.738.498.000;704.600.484.261.501.000
3095;MIRACATU;SP;260;109;369;295.392.953.929.539.000;704.607.046.070.460.000
577;BELA VISTA DE GOIµS;GO;229;96;325;295.384.615.384.615.000;704.615.384.615.384.000
139;ALTEROSA;MG;167;70;237;295.358.649.789.029.000;704.641.350.210.970.000
3801;PIEDADE DE CARATINGA;MG;167;70;237;295.358.649.789.029.000;704.641.350.210.970.000
459;BA÷A FORMOSA;RN;136;57;193;295.336.787.564.766.000;704.663.212.435.233.000
5118;SOLON‡POLE;CE;136;57;193;295.336.787.564.766.000;704.663.212.435.233.000
4993;SELV÷RIA;MS;136;57;193;295.336.787.564.766.000;704.663.212.435.233.000
238;ANGêLICA;MS;105;44;149;295.302.013.422.818.000;704.697.986.577.181.000
1836;FORMOSO;GO;105;44;149;295.302.013.422.818.000;704.697.986.577.181.000
4534;SANTANA DO ARAGUAIA;PA;315;132;447;295.302.013.422.818.000;704.697.986.577.181.000
3367;NOVA MUTUM;MT;105;44;149;295.302.013.422.818.000;704.697.986.577.181.000
4438;SANTA ISABEL;SP;463;194;657;295.281.582.952.815.000;704.718.417.047.184.000
936;CAMBU÷;MG;179;75;254;295.275.590.551.181.000;704.724.409.448.818.000
4719;S«O JO«O DA BOA VISTA;SP;432;181;613;295.269.168.026.101.000;704.730.831.973.898.000
996;CAMPOS BORGES;RS;74;31;105;295.238.095.238.095.000;704.761.904.761.904.000
185;ALVORADA DO SUL;PR;148;62;210;295.238.095.238.095.000;704.761.904.761.904.000
365;ARCOS;MG;370;155;525;295.238.095.238.095.000;704.761.904.761.904.000
1749;FAINA;GO;148;62;210;295.238.095.238.095.000;704.761.904.761.904.000
3651;PASSA SETE;RS;74;31;105;295.238.095.238.095.000;704.761.904.761.904.000
5011;SENADOR SALGADO FILHO;RS;74;31;105;295.238.095.238.095.000;704.761.904.761.904.000
5019;SERAFINA CORR“A;RS;74;31;105;295.238.095.238.095.000;704.761.904.761.904.000
3644;PARNA÷BA;PI;530;222;752;295.212.765.957.446.000;704.787.234.042.553.000
956;CAMPINµPOLIS;MT;117;49;166;295.180.722.891.566.000;704.819.277.108.433.000
4672;S«O FRANCISCO;SP;117;49;166;295.180.722.891.566.000;704.819.277.108.433.000
2103;IBIA÷;MG;160;67;227;295.154.185.022.026.000;704.845.814.977.973.000
3547;PALMARES DO SUL;RS;160;67;227;295.154.185.022.026.000;704.845.814.977.973.000
3056;MEDICIL∂NDIA;PA;203;85;288;295.138.888.888.888.000;704.861.111.111.111.000
2460;ITUPEVA;SP;406;170;576;295.138.888.888.888.000;704.861.111.111.111.000
3889;PITANGA;PR;289;121;410;295.121.951.219.512.000;704.878.048.780.487.000
1650;ECOPORANGA;ES;289;121;410;295.121.951.219.512.000;704.878.048.780.487.000
2079;HORIZONTINA;RS;129;54;183;295.081.967.213.114.000;704.918.032.786.885.000
101;ALCOBAÄA;BA;258;108;366;295.081.967.213.114.000;704.918.032.786.885.000
3600;PARA÷SO DAS µGUAS;MS;86;36;122;295.081.967.213.114.000;704.918.032.786.885.000
2713;LAGOA DOS GATOS;PE;86;36;122;295.081.967.213.114.000;704.918.032.786.885.000
2663;JURANDA;PR;86;36;122;295.081.967.213.114.000;704.918.032.786.885.000
2677;JUSSIAPE;BA;86;36;122;295.081.967.213.114.000;704.918.032.786.885.000
2967;MARIALVA;PR;215;90;305;295.081.967.213.114.000;704.918.032.786.885.000
4597;SANTO ANT‚NIO DO RIO ABAIXO;MG;86;36;122;295.081.967.213.114.000;704.918.032.786.885.000
4589;SANTO ANT‚NIO DO LESTE;MT;86;36;122;295.081.967.213.114.000;704.918.032.786.885.000
4876;S«O MIGUEL DO OESTE;SC;184;77;261;295.019.157.088.122.000;704.980.842.911.877.000
3817;PIMENTEIRAS DO OESTE;RO;98;41;139;294.964.028.776.978.000;705.035.971.223.021.000
249;ANHEMBI;SP;98;41;139;294.964.028.776.978.000;705.035.971.223.021.000
1670;ENCANTADO;RS;98;41;139;294.964.028.776.978.000;705.035.971.223.021.000
3254;NANUQUE;MG;306;128;434;294.930.875.576.036.000;705.069.124.423.963.000
1301;COCALZINHO DE GOIµS;GO;263;110;373;294.906.166.219.839.000;705.093.833.780.160.000
1167;CASCALHO RICO;MG;110;46;156;294.871.794.871.794.000;705.128.205.128.205.000
3154;MONTE ALEGRE DE MINAS;MG;165;69;234;294.871.794.871.794.000;705.128.205.128.205.000
2936;MARAGOGIPE;BA;330;138;468;294.871.794.871.794.000;705.128.205.128.205.000
5060;SERRO;MG;220;92;312;294.871.794.871.794.000;705.128.205.128.205.000
5459;VALENTIM GENTIL;SP;110;46;156;294.871.794.871.794.000;705.128.205.128.205.000
3938;PONTAL DO ARAGUAIA;MT;122;51;173;294.797.687.861.271.000;705.202.312.138.728.000
2987;MARITUBA;PA;500;209;709;294.781.382.228.490.000;705.218.617.771.509.000
3979;PORTO CALVO;AL;189;79;268;294.776.119.402.985.000;705.223.880.597.014.000
28;ACREÈNA;GO;256;107;363;294.765.840.220.385.000;705.234.159.779.614.000
137;ALTAMIRA DO PARANµ;PR;67;28;95;294.736.842.105.263.000;705.263.157.894.736.000
722;BONITO DE MINAS;MG;134;56;190;294.736.842.105.263.000;705.263.157.894.736.000
3439;NOVO SANTO ANT‚NIO;PI;67;28;95;294.736.842.105.263.000;705.263.157.894.736.000
5338;TRIUNFO POTIGUAR;RN;67;28;95;294.736.842.105.263.000;705.263.157.894.736.000
4947;S«O VALêRIO DA NATIVIDADE;TO;67;28;95;294.736.842.105.263.000;705.263.157.894.736.000
2078;HORIZONTE;CE;304;127;431;294.663.573.085.846.000;705.336.426.914.153.000
4836;S«O LOURENÄO DA SERRA;SP;304;127;431;294.663.573.085.846.000;705.336.426.914.153.000
471;BALNEµRIO CAMBORIÈ;SC;383;160;543;294.659.300.184.162.000;705.340.699.815.837.000
1341;CONCEIÄ«O DE MACABU;RJ;316;132;448;294.642.857.142.857.000;705.357.142.857.142.000
3086;MINAS DO LE«O;RS;79;33;112;294.642.857.142.857.000;705.357.142.857.142.000
2921;MAQUINê;RS;91;38;129;294.573.643.410.852.000;705.426.356.589.147.000
3236;MUNHOZ DE MELO;PR;91;38;129;294.573.643.410.852.000;705.426.356.589.147.000
2510;JAGUARETAMA;CE;91;38;129;294.573.643.410.852.000;705.426.356.589.147.000
3942;PONT«O;RS;91;38;129;294.573.643.410.852.000;705.426.356.589.147.000
3824;PINDORAMA DO TOCANTINS;TO;91;38;129;294.573.643.410.852.000;705.426.356.589.147.000
1608;DOM JOAQUIM;MG;91;38;129;294.573.643.410.852.000;705.426.356.589.147.000
512;BARRA DA ESTIVA;BA;91;38;129;294.573.643.410.852.000;705.426.356.589.147.000
120;ALIANÄA DO TOCANTINS;TO;91;38;129;294.573.643.410.852.000;705.426.356.589.147.000
696;BOM JESUS DO TOCANTINS;TO;91;38;129;294.573.643.410.852.000;705.426.356.589.147.000
4999;SENADOR CORTES;MG;91;38;129;294.573.643.410.852.000;705.426.356.589.147.000
2186;ILIC÷NEA;MG;206;86;292;294.520.547.945.205.000;705.479.452.054.794.000
1918;GETÈLIO VARGAS;RS;103;43;146;294.520.547.945.205.000;705.479.452.054.794.000
3852;PIRACANJUBA;GO;206;86;292;294.520.547.945.205.000;705.479.452.054.794.000
4104;QUILOMBO;SC;103;43;146;294.520.547.945.205.000;705.479.452.054.794.000
4704;S«O GONÄALO DO PIAU÷;PI;103;43;146;294.520.547.945.205.000;705.479.452.054.794.000
1831;FORMOSA;GO;436;182;618;294.498.381.877.022.000;705.501.618.122.977.000
3173;MONTE MOR;SP;333;139;472;294.491.525.423.728.000;705.508.474.576.271.000
2054;GUIDOVAL;MG;115;48;163;294.478.527.607.361.000;705.521.472.392.638.000
4766;S«O JOAQUIM DE BICAS;MG;369;154;523;294.455.066.921.606.000;705.544.933.078.393.000
1470;CRISTIANO OTONI;MG;139;58;197;294.416.243.654.822.000;705.583.756.345.177.000
1482;CRUZ ALTA;RS;278;116;394;294.416.243.654.822.000;705.583.756.345.177.000
20;ACARAÈ;CE;151;63;214;294.392.523.364.485.000;705.607.476.635.514.000
2012;GUARµ;SP;163;68;231;294.372.294.372.294.000;705.627.705.627.705.000
2141;IÄARA;SC;163;68;231;294.372.294.372.294.000;705.627.705.627.705.000
4191;RIBEIR«O BONITO;SP;163;68;231;294.372.294.372.294.000;705.627.705.627.705.000
4273;RIO VERDE DE MATO GROSSO;MS;163;68;231;294.372.294.372.294.000;705.627.705.627.705.000
5359;TUPANCIRET«;RS;163;68;231;294.372.294.372.294.000;705.627.705.627.705.000
5236;TEODORO SAMPAIO;BA;163;68;231;294.372.294.372.294.000;705.627.705.627.705.000
4531;SANTANA DE PARNA÷BA;SP;501;209;710;294.366.197.183.098.000;705.633.802.816.901.000
131;ALPIN‡POLIS;MG;175;73;248;294.354.838.709.677.000;705.645.161.290.322.000
348;ARARI;MA;175;73;248;294.354.838.709.677.000;705.645.161.290.322.000
4565;SANTO ANDRê;SP;1115;465;1580;294.303.797.468.354.000;705.696.202.531.645.000
2874;MAGê;RJ;679;283;962;294.178.794.178.794.000;705.821.205.821.205.000
2992;MARQUES DE SOUZA;RS;84;35;119;294.117.647.058.823.000;705.882.352.941.176.000
2974;MARICµ;RJ;540;225;765;294.117.647.058.823.000;705.882.352.941.176.000
2950;MARAVILHAS;MG;144;60;204;294.117.647.058.823.000;705.882.352.941.176.000
3181;MONTEIR‡POLIS;AL;96;40;136;294.117.647.058.823.000;705.882.352.941.176.000
2364;ITANHANGµ;MT;84;35;119;294.117.647.058.823.000;705.882.352.941.176.000
2368;ITAOCA;SP;48;20;68;294.117.647.058.823.000;705.882.352.941.176.000
4250;RIO GRANDE DO PIAU÷;PI;72;30;102;294.117.647.058.823.000;705.882.352.941.176.000
4046;PRESIDENTE J∂NIO QUADROS;BA;108;45;153;294.117.647.058.823.000;705.882.352.941.176.000
517;BARRA DE SANTO ANT‚NIO;AL;192;80;272;294.117.647.058.823.000;705.882.352.941.176.000
559;BARROQUINHA;CE;60;25;85;294.117.647.058.823.000;705.882.352.941.176.000
274;APARECIDA DO RIO DOCE;GO;72;30;102;294.117.647.058.823.000;705.882.352.941.176.000
641;BOA HORA;PI;84;35;119;294.117.647.058.823.000;705.882.352.941.176.000
772;BREJINHO DE NAZARê;TO;72;30;102;294.117.647.058.823.000;705.882.352.941.176.000
1127;CARIRIAÄU;CE;156;65;221;294.117.647.058.823.000;705.882.352.941.176.000
1072;CAPIM;PB;144;60;204;294.117.647.058.823.000;705.882.352.941.176.000
1931;GOIABEIRA;MG;84;35;119;294.117.647.058.823.000;705.882.352.941.176.000
1486;CRUZµLIA;SP;72;30;102;294.117.647.058.823.000;705.882.352.941.176.000
1184;CASTILHO;SP;276;115;391;294.117.647.058.823.000;705.882.352.941.176.000
4595;SANTO ANT‚NIO DO PLANALTO;RS;60;25;85;294.117.647.058.823.000;705.882.352.941.176.000
5321;TR“S FRONTEIRAS;SP;96;40;136;294.117.647.058.823.000;705.882.352.941.176.000
5602;ZABEL“;PB;60;25;85;294.117.647.058.823.000;705.882.352.941.176.000
4725;S«O JO«O DA PONTA;PA;192;80;272;294.117.647.058.823.000;705.882.352.941.176.000
4541;SANTANA DO LIVRAMENTO;RS;389;162;551;294.010.889.292.196.000;705.989.110.707.803.000
870;CACONDE;SP;233;97;330;293.939.393.939.393.000;706.060.606.060.606.000
3312;NOVA ANDRADINA;MS;209;87;296;293.918.918.918.918.000;706.081.081.081.081.000
894;CAIEIRAS;SP;394;164;558;293.906.810.035.842.000;706.093.189.964.157.000
2878;MAIRIPOR«;SP;507;211;718;293.871.866.295.264.000;706.128.133.704.735.000
2386;ITAPETINGA;BA;334;139;473;293.868.921.775.898.000;706.131.078.224.101.000
637;BOA ESPERANÄA;MG;334;139;473;293.868.921.775.898.000;706.131.078.224.101.000
898;CAJAPI‡;MA;161;67;228;293.859.649.122.807.000;706.140.350.877.192.000
3256;NAQUE;MG;161;67;228;293.859.649.122.807.000;706.140.350.877.192.000
5207;TAQUARIVA÷;SP;149;62;211;293.838.862.559.241.000;706.161.137.440.758.000
2517;JAGUARUANA;CE;137;57;194;293.814.432.989.690.000;706.185.567.010.309.000
3291;NITER‡I;RJ;887;369;1256;293.789.808.917.197.000;706.210.191.082.802.000
3036;MATÂES DO NORTE;MA;125;52;177;293.785.310.734.463.000;706.214.689.265.536.000
486;BANDEIRANTES;MS;125;52;177;293.785.310.734.463.000;706.214.689.265.536.000
1708;ESPERANTINA;PI;250;104;354;293.785.310.734.463.000;706.214.689.265.536.000
920;CAMACAN;BA;238;99;337;293.768.545.994.065.000;706.231.454.005.934.000
3066;MERUOCA;CE;113;47;160;293.750.000.000.000.000;706.250.000.000.000.000
4416;SANTA EFIG“NIA DE MINAS;MG;113;47;160;293.750.000.000.000.000;706.250.000.000.000.000
3687;PAULICêIA;SP;113;47;160;293.750.000.000.000.000;706.250.000.000.000.000
1213;CAXIAS DO SUL;RS;666;277;943;293.743.372.216.330.000;706.256.627.783.669.000
2337;ITAITUBA;PA;315;131;446;293.721.973.094.170.000;706.278.026.905.829.000
5570;VIT‡RIA DA CONQUISTA;BA;630;262;892;293.721.973.094.170.000;706.278.026.905.829.000
3048;MAURIL∂NDIA DO TOCANTINS;TO;101;42;143;293.706.293.706.293.000;706.293.706.293.706.000
3533;PAINEL;SC;101;42;143;293.706.293.706.293.000;706.293.706.293.706.000
4072;PROMISS«O;SP;291;121;412;293.689.320.388.349.000;706.310.679.611.650.000
4012;POTIRENDABA;SP;190;79;269;293.680.297.397.769.000;706.319.702.602.230.000
3517;PACARAIMA;RR;190;79;269;293.680.297.397.769.000;706.319.702.602.230.000
1994;GUA÷RA;PR;190;79;269;293.680.297.397.769.000;706.319.702.602.230.000
761;BRAS÷LIA DE MINAS;MG;190;79;269;293.680.297.397.769.000;706.319.702.602.230.000
442;AVARê;SP;421;175;596;293.624.161.073.825.000;706.375.838.926.174.000
160;ALTO PARA÷SO;RO;166;69;235;293.617.021.276.595.000;706.382.978.723.404.000
3647;PARNARAMA;MA;166;69;235;293.617.021.276.595.000;706.382.978.723.404.000
3307;NOVA ALIANÄA DO IVA÷;PR;77;32;109;293.577.981.651.376.000;706.422.018.348.623.000
2692;LAGO DOS RODRIGUES;MA;77;32;109;293.577.981.651.376.000;706.422.018.348.623.000
1537;DAMOL∂NDIA;GO;77;32;109;293.577.981.651.376.000;706.422.018.348.623.000
4624;S«O BENTO DO TRAIR÷;RN;77;32;109;293.577.981.651.376.000;706.422.018.348.623.000
4869;S«O MIGUEL DO ANTA;MG;154;64;218;293.577.981.651.376.000;706.422.018.348.623.000
5044;SERRA NOVA DOURADA;MT;77;32;109;293.577.981.651.376.000;706.422.018.348.623.000
1235;CERQUEIRA CêSAR;SP;219;91;310;293.548.387.096.774.000;706.451.612.903.225.000
4095;QUEIMADAS;BA;142;59;201;293.532.338.308.457.000;706.467.661.691.542.000
3184;MONTES CLAROS;MG;905;376;1281;293.520.686.963.309.000;706.479.313.036.690.000
1295;COARI;AM;402;167;569;293.497.363.796.133.000;706.502.636.203.866.000
2122;IBIRAIARAS;RS;65;27;92;293.478.260.869.565.000;706.521.739.130.434.000
616;BERNARDO DO MEARIM;MA;65;27;92;293.478.260.869.565.000;706.521.739.130.434.000
1147;CARNAÈBA DOS DANTAS;RN;65;27;92;293.478.260.869.565.000;706.521.739.130.434.000
4394;SANTA CLARA D'OESTE;SP;65;27;92;293.478.260.869.565.000;706.521.739.130.434.000
3529;PAIAL;SC;65;27;92;293.478.260.869.565.000;706.521.739.130.434.000
5085;SILVEIRAS;SP;130;54;184;293.478.260.869.565.000;706.521.739.130.434.000
5114;SOLEDADE;RS;195;81;276;293.478.260.869.565.000;706.521.739.130.434.000
3981;PORTO DE MOZ;PA;183;76;259;293.436.293.436.293.000;706.563.706.563.706.000
5554;VIRADOURO;SP;183;76;259;293.436.293.436.293.000;706.563.706.563.706.000
3130;MOGI MIRIM;SP;484;201;685;293.430.656.934.306.000;706.569.343.065.693.000
4841;S«O LU÷S;MA;1387;576;1963;293.428.425.878.757.000;706.571.574.121.242.000
4223;RIO CLARO;RJ;236;98;334;293.413.173.652.694.000;706.586.826.347.305.000
126;ALMIRANTE TAMANDARê;PR;472;196;668;293.413.173.652.694.000;706.586.826.347.305.000
3123;MOCOCA;SP;342;142;484;293.388.429.752.066.000;706.611.570.247.933.000
1349;CONCEIÄ«O DO MATO DENTRO;MG;224;93;317;293.375.394.321.766.000;706.624.605.678.233.000
5147;TABO«O DA SERRA;SP;554;230;784;293.367.346.938.775.000;706.632.653.061.224.000
543;BARRAS;PI;159;66;225;293.333.333.333.333.000;706.666.666.666.666.000
3472;OLIVENÄA;AL;106;44;150;293.333.333.333.333.000;706.666.666.666.666.000
4455;SANTA LUZIA DO PARµ;PA;147;61;208;293.269.230.769.230.000;706.730.769.230.769.000
2420;ITARANA;ES;147;61;208;293.269.230.769.230.000;706.730.769.230.769.000
1949;GONGOGI;BA;147;61;208;293.269.230.769.230.000;706.730.769.230.769.000
5428;URUAÄU;GO;294;122;416;293.269.230.769.230.000;706.730.769.230.769.000
1212;CAXIAS;MA;470;195;665;293.233.082.706.766.000;706.766.917.293.233.000
3636;PARELHAS;RN;94;39;133;293.233.082.706.766.000;706.766.917.293.233.000
2697;LAGOA DA CANOA;AL;135;56;191;293.193.717.277.486.000;706.806.282.722.513.000
280;APIACµS;MT;135;56;191;293.193.717.277.486.000;706.806.282.722.513.000
3825;PINDORETAMA;CE;217;90;307;293.159.609.120.521.000;706.840.390.879.478.000
993;CAMPO VERDE;MT;258;107;365;293.150.684.931.506.000;706.849.315.068.493.000
618;BERTIOGA;SP;299;124;423;293.144.208.037.825.000;706.855.791.962.174.000
1951;GOUVEIA;MG;164;68;232;293.103.448.275.862.000;706.896.551.724.137.000
3901;PLANALTINO;BA;82;34;116;293.103.448.275.862.000;706.896.551.724.137.000
3473;ONÄA DE PITANGUI;MG;123;51;174;293.103.448.275.862.000;706.896.551.724.137.000
3535;PAIVA;MG;82;34;116;293.103.448.275.862.000;706.896.551.724.137.000
2456;ITUETA;MG;82;34;116;293.103.448.275.862.000;706.896.551.724.137.000
952;CAMPINA GRANDE;PB;767;318;1085;293.087.557.603.686.000;706.912.442.396.313.000
206;AMONTADA;CE;234;97;331;293.051.359.516.616.000;706.948.640.483.383.000
4846;S«O LU÷S DO QUITUNDE;AL;234;97;331;293.051.359.516.616.000;706.948.640.483.383.000
338;ARAPOTI;PR;193;80;273;293.040.293.040.293.000;706.959.706.959.706.000
4781;S«O JOSê DA TAPERA;AL;193;80;273;293.040.293.040.293.000;706.959.706.959.706.000
4683;S«O FRANCISCO DO GUAPORê;RO;193;80;273;293.040.293.040.293.000;706.959.706.959.706.000
1647;DUQUE DE CAXIAS;RJ;1450;601;2051;293.027.791.321.306.000;706.972.208.678.693.000
2773;LEBON RêGIS;SC;152;63;215;293.023.255.813.953.000;706.976.744.186.046.000
4680;S«O FRANCISCO DO BREJ«O;MA;152;63;215;293.023.255.813.953.000;706.976.744.186.046.000
3986;PORTO ESTRELA;MT;111;46;157;292.993.630.573.248.000;707.006.369.426.751.000
3834;PINHALZINHO;SC;111;46;157;292.993.630.573.248.000;707.006.369.426.751.000
1182;CASTELO;ES;333;138;471;292.993.630.573.248.000;707.006.369.426.751.000
3025;MATINHOS;PR;292;121;413;292.978.208.232.445.000;707.021.791.767.554.000
2306;ITABIRITO;MG;420;174;594;292.929.292.929.292.000;707.070.707.070.707.000
3877;PIRASSUNUNGA;SP;350;145;495;292.929.292.929.292.000;707.070.707.070.707.000
1207;CATUTI;MG;70;29;99;292.929.292.929.292.000;707.070.707.070.707.000
1709;ESPERANTINA;TO;140;58;198;292.929.292.929.292.000;707.070.707.070.707.000
173;ALVARENGA;MG;70;29;99;292.929.292.929.292.000;707.070.707.070.707.000
21;ACARI;RN;70;29;99;292.929.292.929.292.000;707.070.707.070.707.000
642;BOA NOVA;BA;210;87;297;292.929.292.929.292.000;707.070.707.070.707.000
4633;S«O BRAZ DO PIAU÷;PI;70;29;99;292.929.292.929.292.000;707.070.707.070.707.000
5396;UCHOA;SP;140;58;198;292.929.292.929.292.000;707.070.707.070.707.000
5320;TR“S FORQUILHAS;RS;70;29;99;292.929.292.929.292.000;707.070.707.070.707.000
4762;S«O JO«O EVANGELISTA;MG;169;70;239;292.887.029.288.702.000;707.112.970.711.297.000
1659;ELIAS FAUSTO;SP;268;111;379;292.875.989.445.910.000;707.124.010.554.089.000
2942;MARAPANIM;PA;268;111;379;292.875.989.445.910.000;707.124.010.554.089.000
4880;S«O MIGUEL DOS CAMPOS;AL;268;111;379;292.875.989.445.910.000;707.124.010.554.089.000
3671;PATOS DE MINAS;MG;367;152;519;292.870.905.587.668.000;707.129.094.412.331.000
3693;PAULIST∂NIA;SP;99;41;140;292.857.142.857.142.000;707.142.857.142.857.000
3637;PARICONHA;AL;99;41;140;292.857.142.857.142.000;707.142.857.142.857.000
3438;NOVO SANTO ANT‚NIO;MT;99;41;140;292.857.142.857.142.000;707.142.857.142.857.000
3909;PLATINA;SP;99;41;140;292.857.142.857.142.000;707.142.857.142.857.000
2465;ITUVERAVA;SP;198;82;280;292.857.142.857.142.000;707.142.857.142.857.000
1688;ENVIRA;AM;198;82;280;292.857.142.857.142.000;707.142.857.142.857.000
4694;S«O GERALDO;MG;99;41;140;292.857.142.857.142.000;707.142.857.142.857.000
2023;GUARAMIRANGA;CE;128;53;181;292.817.679.558.011.000;707.182.320.441.988.000
3787;PETROLINA;PE;512;212;724;292.817.679.558.011.000;707.182.320.441.988.000
3711;PEDRA BELA;SP;128;53;181;292.817.679.558.011.000;707.182.320.441.988.000
4217;RIO BRANCO;AC;599;248;847;292.798.110.979.929.000;707.201.889.020.070.000
4136;RECREIO;MG;157;65;222;292.792.792.792.792.000;707.207.207.207.207.000
4131;RAPOSOS;MG;314;130;444;292.792.792.792.792.000;707.207.207.207.207.000
4717;S«O JO«O DA BALIZA;RR;186;77;263;292.775.665.399.239.000;707.224.334.600.760.000
326;ARAMARI;BA;215;89;304;292.763.157.894.736.000;707.236.842.105.263.000
1880;FRUTAL;MG;244;101;345;292.753.623.188.405.000;707.246.376.811.594.000
1347;CONCEIÄ«O DO JACU÷PE;BA;261;108;369;292.682.926.829.268.000;707.317.073.170.731.000
107;ALEGRIA;RS;58;24;82;292.682.926.829.268.000;707.317.073.170.731.000
709;BOM SUCESSO DE ITARARê;SP;116;48;164;292.682.926.829.268.000;707.317.073.170.731.000
3393;NOVA SANTA HELENA;MT;87;36;123;292.682.926.829.268.000;707.317.073.170.731.000
3397;NOVA SERRANA;MG;406;168;574;292.682.926.829.268.000;707.317.073.170.731.000
4871;S«O MIGUEL DO FIDALGO;PI;58;24;82;292.682.926.829.268.000;707.317.073.170.731.000
5066;SERT«O SANTANA;RS;87;36;123;292.682.926.829.268.000;707.317.073.170.731.000
591;BELFORD ROXO;RJ;1281;530;1811;292.655.991.165.102.000;707.344.008.834.897.000
2908;MANGARATIBA;RJ;394;163;557;292.639.138.240.574.000;707.360.861.759.425.000
3212;MORROS;MA;191;79;270;292.592.592.592.592.000;707.407.407.407.407.000
2410;ITAPU« DO OESTE;RO;191;79;270;292.592.592.592.592.000;707.407.407.407.407.000
2645;JUIZ DE FORA;MG;926;383;1309;292.589.763.177.998.000;707.410.236.822.001.000
2524;JANAÈBA;MG;324;134;458;292.576.419.213.973.000;707.423.580.786.026.000
2934;MARACµS;BA;162;67;229;292.576.419.213.973.000;707.423.580.786.026.000
4533;SANTANA DO ACARAÈ;CE;133;55;188;292.553.191.489.361.000;707.446.808.510.638.000
4743;S«O JO«O DO IVA÷;PR;133;55;188;292.553.191.489.361.000;707.446.808.510.638.000
672;BOM DESPACHO;MG;237;98;335;292.537.313.432.835.000;707.462.686.567.164.000
529;BARRA DO OURO;TO;104;43;147;292.517.006.802.721.000;707.482.993.197.278.000
4309;ROSµRIO DO CATETE;SE;104;43;147;292.517.006.802.721.000;707.482.993.197.278.000
3635;PARECIS;RO;104;43;147;292.517.006.802.721.000;707.482.993.197.278.000
2506;JAGUARAÄU;MG;104;43;147;292.517.006.802.721.000;707.482.993.197.278.000
5461;VALPARA÷SO;SP;208;86;294;292.517.006.802.721.000;707.482.993.197.278.000
4;ABAETETUBA;PA;491;203;694;292.507.204.610.951.000;707.492.795.389.048.000
5484;VµRZEA DA PALMA;MG;329;136;465;292.473.118.279.569.000;707.526.881.720.430.000
2661;JUQUITIBA;SP;300;124;424;292.452.830.188.679.000;707.547.169.811.320.000
4176;RIACHO DE SANTO ANT‚NIO;PB;75;31;106;292.452.830.188.679.000;707.547.169.811.320.000
5032;SERRA DA RAIZ;PB;75;31;106;292.452.830.188.679.000;707.547.169.811.320.000
440;AVA÷;SP;121;50;171;292.397.660.818.713.000;707.602.339.181.286.000
668;BODOQUENA;MS;121;50;171;292.397.660.818.713.000;707.602.339.181.286.000
1428;CORRENTE;PI;121;50;171;292.397.660.818.713.000;707.602.339.181.286.000
4860;S«O MATEUS DO SUL;PR;259;107;366;292.349.726.775.956.000;707.650.273.224.043.000
1186;CASTRO ALVES;BA;184;76;260;292.307.692.307.692.000;707.692.307.692.307.000
904;CAJOBI;SP;138;57;195;292.307.692.307.692.000;707.692.307.692.307.000
19;ACARAPE;CE;184;76;260;292.307.692.307.692.000;707.692.307.692.307.000
165;ALTO RIO DOCE;MG;138;57;195;292.307.692.307.692.000;707.692.307.692.307.000
4033;PRAT∂NIA;SP;184;76;260;292.307.692.307.692.000;707.692.307.692.307.000
2739;LAJEADO NOVO;MA;92;38;130;292.307.692.307.692.000;707.692.307.692.307.000
3089;MINDURI;MG;138;57;195;292.307.692.307.692.000;707.692.307.692.307.000
4816;S«O JOSê DO POVO;MT;92;38;130;292.307.692.307.692.000;707.692.307.692.307.000
5556;VIRG÷NIA;MG;92;38;130;292.307.692.307.692.000;707.692.307.692.307.000
5537;VIGIA;PA;322;133;455;292.307.692.307.692.000;707.692.307.692.307.000
5211;TARAUACµ;AC;184;76;260;292.307.692.307.692.000;707.692.307.692.307.000
2965;MARIA DA Fê;MG;247;102;349;292.263.610.315.186.000;707.736.389.684.813.000
2220;INHANGAPI;PA;155;64;219;292.237.442.922.374.000;707.762.557.077.625.000
4848;S«O LUIZ;RR;155;64;219;292.237.442.922.374.000;707.762.557.077.625.000
1665;EMBAÈBA;SP;109;45;154;292.207.792.207.792.000;707.792.207.792.207.000
199;AMêLIA RODRIGUES;BA;327;135;462;292.207.792.207.792.000;707.792.207.792.207.000
2720;LAGOA GRANDE DO MARANH«O;MA;109;45;154;292.207.792.207.792.000;707.792.207.792.207.000
1009;CANA« DOS CARAJµS;PA;281;116;397;292.191.435.768.261.000;707.808.564.231.738.000
548;BARREIRINHAS;MA;344;142;486;292.181.069.958.847.000;707.818.930.041.152.000
1324;COLORADO;PR;172;71;243;292.181.069.958.847.000;707.818.930.041.152.000
3486;ORTIGUEIRA;PR;172;71;243;292.181.069.958.847.000;707.818.930.041.152.000
2774;LEME;SP;470;194;664;292.168.674.698.795.000;707.831.325.301.204.000
4210;RIN‡POLIS;SP;126;52;178;292.134.831.460.674.000;707.865.168.539.325.000
1297;COCAL DE TELHA;PI;63;26;89;292.134.831.460.674.000;707.865.168.539.325.000
1622;DORES DE GUANH«ES;MG;126;52;178;292.134.831.460.674.000;707.865.168.539.325.000
1731;ESTRELA DO INDAIµ;MG;63;26;89;292.134.831.460.674.000;707.865.168.539.325.000
243;ANGICO;TO;63;26;89;292.134.831.460.674.000;707.865.168.539.325.000
2537;JAPERI;RJ;584;241;825;292.121.212.121.212.000;707.878.787.878.787.000
2344;ITAJUBµ;MG;412;170;582;292.096.219.931.271.000;707.903.780.068.728.000
3246;MURITIBA;BA;286;118;404;292.079.207.920.792.000;707.920.792.079.207.000
1788;FERNAND‡POLIS;SP;286;118;404;292.079.207.920.792.000;707.920.792.079.207.000
1187;CATAGUASES;MG;463;191;654;292.048.929.663.608.000;707.951.070.336.391.000
2342;ITAJU;SP;80;33;113;292.035.398.230.088.000;707.964.601.769.911.000
3718;PEDRA DOURADA;MG;80;33;113;292.035.398.230.088.000;707.964.601.769.911.000
4145;REGENTE FEIJ‡;SP;177;73;250;292.000.000.000.000.000;708.000.000.000.000.000
983;CAMPO LARGO DO PIAU÷;PI;97;40;137;291.970.802.919.708.000;708.029.197.080.291.000
5062;SERTANEJA;PR;97;40;137;291.970.802.919.708.000;708.029.197.080.291.000
5158;TAGUATINGA;TO;194;80;274;291.970.802.919.708.000;708.029.197.080.291.000
624;BETIM;MG;1004;414;1418;291.960.507.757.404.000;708.039.492.242.595.000
2902;MANDAGUAÄU;PR;211;87;298;291.946.308.724.832.000;708.053.691.275.167.000
288;APUCARANA;PR;325;134;459;291.938.997.821.350.000;708.061.002.178.649.000
2688;LAGARTO;SE;342;141;483;291.925.465.838.509.000;708.074.534.161.490.000
4034;PRATµPOLIS;MG;131;54;185;291.891.891.891.891.000;708.108.108.108.108.000
751;BRANQUINHA;AL;131;54;185;291.891.891.891.891.000;708.108.108.108.108.000
2937;MARAIAL;PE;182;75;257;291.828.793.774.319.000;708.171.206.225.680.000
5081;SILV∂NIA;GO;199;82;281;291.814.946.619.217.000;708.185.053.380.782.000
3728;PEDRAS DE FOGO;PB;216;89;305;291.803.278.688.524.000;708.196.721.311.475.000
2161;IGARASSU;PE;432;178;610;291.803.278.688.524.000;708.196.721.311.475.000
5380;UARINI;AM;233;96;329;291.793.313.069.908.000;708.206.686.930.091.000
1399;CORINTO;MG;284;117;401;291.770.573.566.084.000;708.229.426.433.915.000
5122;SOROCABA;SP;869;358;1227;291.768.541.157.294.000;708.231.458.842.705.000
1544;DELFIM MOREIRA;MG;136;56;192;291.666.666.666.666.000;708.333.333.333.333.000
1764;FAXINALZINHO;RS;68;28;96;291.666.666.666.666.000;708.333.333.333.333.000
706;BOM SUCESSO;MG;221;91;312;291.666.666.666.666.000;708.333.333.333.333.000
1057;CAP«O ALTO;SC;85;35;120;291.666.666.666.666.000;708.333.333.333.333.000
41;AGRESTINA;PE;153;63;216;291.666.666.666.666.000;708.333.333.333.333.000
449;BACABAL;MA;323;133;456;291.666.666.666.666.000;708.333.333.333.333.000
298;ARAÄARIGUAMA;SP;340;140;480;291.666.666.666.666.000;708.333.333.333.333.000
415;ASSÈ;RN;221;91;312;291.666.666.666.666.000;708.333.333.333.333.000
3743;PEDRO GOMES;MS;102;42;144;291.666.666.666.666.000;708.333.333.333.333.000
3560;PALMEIRANTE;TO;85;35;120;291.666.666.666.666.000;708.333.333.333.333.000
3625;PARARI;PB;51;21;72;291.666.666.666.666.000;708.333.333.333.333.000
3591;PARAGUAÄU PAULISTA;SP;272;112;384;291.666.666.666.666.000;708.333.333.333.333.000
4113;QUITERIAN‡POLIS;CE;68;28;96;291.666.666.666.666.000;708.333.333.333.333.000
4148;RELVADO;RS;51;21;72;291.666.666.666.666.000;708.333.333.333.333.000
4526;SANTANA DA BOA VISTA;RS;85;35;120;291.666.666.666.666.000;708.333.333.333.333.000
4487;SANTA RITA DO ARAGUAIA;GO;136;56;192;291.666.666.666.666.000;708.333.333.333.333.000
2923;MAR VERMELHO;AL;68;28;96;291.666.666.666.666.000;708.333.333.333.333.000
3119;MIRINZAL;MA;170;70;240;291.666.666.666.666.000;708.333.333.333.333.000
3004;MASSAP“ DO PIAU÷;PI;68;28;96;291.666.666.666.666.000;708.333.333.333.333.000
3398;NOVA SOURE;BA;153;63;216;291.666.666.666.666.000;708.333.333.333.333.000
3324;NOVA CANA«;BA;102;42;144;291.666.666.666.666.000;708.333.333.333.333.000
2653;JUNDIµ;AL;153;63;216;291.666.666.666.666.000;708.333.333.333.333.000
2619;J‡IA;RS;85;35;120;291.666.666.666.666.000;708.333.333.333.333.000
2335;ITAIPUL∂NDIA;PR;119;49;168;291.666.666.666.666.000;708.333.333.333.333.000
2547;JARAGUµ;GO;238;98;336;291.666.666.666.666.000;708.333.333.333.333.000
5017;SENTINELA DO SUL;RS;102;42;144;291.666.666.666.666.000;708.333.333.333.333.000
4783;S«O JOSê DA VIT‡RIA;BA;119;49;168;291.666.666.666.666.000;708.333.333.333.333.000
4652;S«O DOMINGOS DO CARIRI;PB;68;28;96;291.666.666.666.666.000;708.333.333.333.333.000
5384;UBA÷RA;BA;153;63;216;291.666.666.666.666.000;708.333.333.333.333.000
5275;TIMBURI;SP;102;42;144;291.666.666.666.666.000;708.333.333.333.333.000
859;CACHOEIRAS DE MACACU;RJ;379;156;535;291.588.785.046.728.000;708.411.214.953.271.000
5418;UNI«O DOS PALMARES;AL;294;121;415;291.566.265.060.240.000;708.433.734.939.759.000
1294;COARACI;BA;243;100;343;291.545.189.504.373.000;708.454.810.495.626.000
4336;SALES‡POLIS;SP;243;100;343;291.545.189.504.373.000;708.454.810.495.626.000
1357;CONC‡RDIA DO PARµ;PA;192;79;271;291.512.915.129.151.000;708.487.084.870.848.000
1439;CORURIPE;AL;192;79;271;291.512.915.129.151.000;708.487.084.870.848.000
2822;LUIS CORREIA;PI;175;72;247;291.497.975.708.502.000;708.502.024.291.497.000
4850;S«O LUIZ GONZAGA;RS;158;65;223;291.479.820.627.802.000;708.520.179.372.197.000
5028;SERRA AZUL;SP;158;65;223;291.479.820.627.802.000;708.520.179.372.197.000
3298;NOSSA SENHORA DA GL‡RIA;SE;141;58;199;291.457.286.432.160.000;708.542.713.567.839.000
2914;MANOEL RIBAS;PR;141;58;199;291.457.286.432.160.000;708.542.713.567.839.000
4101;QUER“NCIA;MT;141;58;199;291.457.286.432.160.000;708.542.713.567.839.000
2172;IGUATAMA;MG;141;58;199;291.457.286.432.160.000;708.542.713.567.839.000
540;BARRA VELHA;SC;141;58;199;291.457.286.432.160.000;708.542.713.567.839.000
2026;GUARANI;MG;124;51;175;291.428.571.428.571.000;708.571.428.571.428.000
2056;GUIMAR∂NIA;MG;124;51;175;291.428.571.428.571.000;708.571.428.571.428.000
4418;SANTA Fê;PR;124;51;175;291.428.571.428.571.000;708.571.428.571.428.000
1684;ENTRE RIOS DE MINAS;MG;231;95;326;291.411.042.944.785.000;708.588.957.055.214.000
429;AUGUSTO DE LIMA;MG;107;44;151;291.390.728.476.821.000;708.609.271.523.178.000
2464;ITUTINGA;MG;107;44;151;291.390.728.476.821.000;708.609.271.523.178.000
2230;IPABA;MG;287;118;405;291.358.024.691.358.000;708.641.975.308.641.000
363;ARCEBURGO;MG;90;37;127;291.338.582.677.165.000;708.661.417.322.834.000
516;BARRA DE SANTANA;PB;90;37;127;291.338.582.677.165.000;708.661.417.322.834.000
1055;CAPANEMA;PR;90;37;127;291.338.582.677.165.000;708.661.417.322.834.000
918;CALMON;SC;90;37;127;291.338.582.677.165.000;708.661.417.322.834.000
2543;JAPURµ;AM;180;74;254;291.338.582.677.165.000;708.661.417.322.834.000
3223;MUCUG“;BA;90;37;127;291.338.582.677.165.000;708.661.417.322.834.000
4621;S«O BENTO DO SAPUCA÷;SP;180;74;254;291.338.582.677.165.000;708.661.417.322.834.000
2005;GUAPIAÄU;SP;163;67;230;291.304.347.826.086.000;708.695.652.173.913.000
105;ALEGRETE;RS;236;97;333;291.291.291.291.291.000;708.708.708.708.708.000
2939;MARANGUAPE;CE;382;157;539;291.280.148.423.005.000;708.719.851.576.994.000
2960;MARECHAL DEODORO;AL;292;120;412;291.262.135.922.330.000;708.737.864.077.669.000
4227;RIO DAS ANTAS;SC;73;30;103;291.262.135.922.330.000;708.737.864.077.669.000
804;BURI;SP;219;90;309;291.262.135.922.330.000;708.737.864.077.669.000
1897;GARIBALDI;RS;146;60;206;291.262.135.922.330.000;708.737.864.077.669.000
1706;ESPERANÄA DO SUL;RS;73;30;103;291.262.135.922.330.000;708.737.864.077.669.000
4690;S«O GABRIEL;BA;146;60;206;291.262.135.922.330.000;708.737.864.077.669.000
4811;S«O JOSê DO MANTIMENTO;MG;73;30;103;291.262.135.922.330.000;708.737.864.077.669.000
5196;TAPIRATIBA;SP;219;90;309;291.262.135.922.330.000;708.737.864.077.669.000
5605;ZORTêA;SC;73;30;103;291.262.135.922.330.000;708.737.864.077.669.000
701;BOM PRINC÷PIO DO PIAU÷;PI;129;53;182;291.208.791.208.791.000;708.791.208.791.208.000
503;BARBOSA;SP;129;53;182;291.208.791.208.791.000;708.791.208.791.208.000
4695;S«O GERALDO DA PIEDADE;MG;129;53;182;291.208.791.208.791.000;708.791.208.791.208.000
5099;SIRIRI;SE;129;53;182;291.208.791.208.791.000;708.791.208.791.208.000
2332;ITAI‡POLIS;SC;185;76;261;291.187.739.463.601.000;708.812.260.536.398.000
3914;POÄO BRANCO;RN;112;46;158;291.139.240.506.329.000;708.860.759.493.670.000
2222;INHAPIM;MG;168;69;237;291.139.240.506.329.000;708.860.759.493.670.000
2218;INHACORµ;RS;56;23;79;291.139.240.506.329.000;708.860.759.493.670.000
1712;ESPIG«O DO OESTE;RO;207;85;292;291.095.890.410.958.000;708.904.109.589.041.000
3882;PIREN‡POLIS;GO;207;85;292;291.095.890.410.958.000;708.904.109.589.041.000
3766;PERDIG«O;MG;151;62;213;291.079.812.206.572.000;708.920.187.793.427.000
2148;ICONHA;ES;151;62;213;291.079.812.206.572.000;708.920.187.793.427.000
4982;SCHROEDER;SC;151;62;213;291.079.812.206.572.000;708.920.187.793.427.000
246;ANGUERA;BA;95;39;134;291.044.776.119.402.000;708.955.223.880.597.000
3345;NOVA GRANADA;SP;190;78;268;291.044.776.119.402.000;708.955.223.880.597.000
52;µGUA CLARA;MS;134;55;189;291.005.291.005.291.000;708.994.708.994.708.000
1920;GIRAU DO PONCIANO;AL;134;55;189;291.005.291.005.291.000;708.994.708.994.708.000
1972;GRAMADO XAVIER;RS;134;55;189;291.005.291.005.291.000;708.994.708.994.708.000
4810;S«O JOSê DO JACURI;MG;134;55;189;291.005.291.005.291.000;708.994.708.994.708.000
3383;NOVA PRATA;RS;173;71;244;290.983.606.557.377.000;709.016.393.442.622.000
3052;MAZAG«O;AP;173;71;244;290.983.606.557.377.000;709.016.393.442.622.000
5382;UBµ;MG;346;142;488;290.983.606.557.377.000;709.016.393.442.622.000
3519;PACATUBA;CE;385;158;543;290.976.058.931.860.000;709.023.941.068.139.000
3470;OLIVEIRA DOS BREJINHOS;BA;78;32;110;290.909.090.909.090.000;709.090.909.090.909.000
3607;PARAMOTI;CE;117;48;165;290.909.090.909.090.000;709.090.909.090.909.000
3668;PATO BRAGADO;PR;78;32;110;290.909.090.909.090.000;709.090.909.090.909.000
2938;MARAJµ DO SENA;MA;117;48;165;290.909.090.909.090.000;709.090.909.090.909.000
2244;IPIGUµ;SP;117;48;165;290.909.090.909.090.000;709.090.909.090.909.000
1298;COCAL DO SUL;SC;156;64;220;290.909.090.909.090.000;709.090.909.090.909.000
1308;COIVARAS;PI;78;32;110;290.909.090.909.090.000;709.090.909.090.909.000
275;APARECIDA DO RIO NEGRO;TO;78;32;110;290.909.090.909.090.000;709.090.909.090.909.000
4560;SANTO AMARO;BA;490;201;691;290.882.778.581.765.000;709.117.221.418.234.000
2138;IBIÈNA;SP;590;242;832;290.865.384.615.384.000;709.134.615.384.615.000
2569;JATOBµ;PE;139;57;196;290.816.326.530.612.000;709.183.673.469.387.000
2756;LARANJAL;PR;139;57;196;290.816.326.530.612.000;709.183.673.469.387.000
4700;S«O GONÄALO DO AMARANTE;CE;278;114;392;290.816.326.530.612.000;709.183.673.469.387.000
2197;IMPERATRIZ;MA;578;237;815;290.797.546.012.269.000;709.202.453.987.730.000
4819;S«O JOSê DO RIO PRETO;SP;678;278;956;290.794.979.079.497.000;709.205.020.920.502.000
2010;GUAPORê;RS;100;41;141;290.780.141.843.971.000;709.219.858.156.028.000
4457;SANTA MARGARIDA;MG;100;41;141;290.780.141.843.971.000;709.219.858.156.028.000
3620;PARANATINGA;MT;200;82;282;290.780.141.843.971.000;709.219.858.156.028.000
3771;PEREIRO;CE;100;41;141;290.780.141.843.971.000;709.219.858.156.028.000
1902;GASPAR;SC;261;107;368;290.760.869.565.217.000;709.239.130.434.782.000
4891;S«O PEDRO DA ALDEIA;RJ;422;173;595;290.756.302.521.008.000;709.243.697.478.991.000
688;BOM JESUS DE GOIµS;GO;161;66;227;290.748.898.678.414.000;709.251.101.321.585.000
841;CAÄAPAVA DO SUL;RS;161;66;227;290.748.898.678.414.000;709.251.101.321.585.000
1677;ENGENHEIRO COELHO;SP;222;91;313;290.734.824.281.150.000;709.265.175.718.849.000
3258;NATAL;RN;993;407;1400;290.714.285.714.285.000;709.285.714.285.714.000
3336;NOVA ESPERANÄA DO PIRIµ;PA;122;50;172;290.697.674.418.604.000;709.302.325.581.395.000
3305;NOSSA SENHORA DOS REMêDIOS;PI;122;50;172;290.697.674.418.604.000;709.302.325.581.395.000
5074;SEVERIANO DE ALMEIDA;RS;61;25;86;290.697.674.418.604.000;709.302.325.581.395.000
3446;‡BIDOS;PA;266;109;375;290.666.666.666.666.000;709.333.333.333.333.000
2445;ITINGA DO MARANH«O;MA;205;84;289;290.657.439.446.366.000;709.342.560.553.633.000
4921;S«O SEBASTI«O DA BOA VISTA;PA;205;84;289;290.657.439.446.366.000;709.342.560.553.633.000
2500;JACUNDµ;PA;288;118;406;290.640.394.088.669.000;709.359.605.911.330.000
5267;TIJUCAS;SC;144;59;203;290.640.394.088.669.000;709.359.605.911.330.000
507;BARCELOS;AM;227;93;320;290.625.000.000.000.000;709.375.000.000.000.000
809;BURITI DE GOIµS;GO;83;34;117;290.598.290.598.290.000;709.401.709.401.709.000
3334;NOVA ERECHIM;SC;83;34;117;290.598.290.598.290.000;709.401.709.401.709.000
4431;SANTA HELENA DE GOIµS;GO;249;102;351;290.598.290.598.290.000;709.401.709.401.709.000
5515;VERTENTE DO LêRIO;PE;83;34;117;290.598.290.598.290.000;709.401.709.401.709.000
2792;LIMOEIRO DO AJURU;PA;188;77;265;290.566.037.735.849.000;709.433.962.264.150.000
3405;NOVA VENêCIA;ES;293;120;413;290.556.900.726.392.000;709.443.099.273.607.000
468;BALIZA;GO;105;43;148;290.540.540.540.540.000;709.459.459.459.459.000
5093;SIMONêSIA;MG;210;86;296;290.540.540.540.540.000;709.459.459.459.459.000
3340;NOVA FµTIMA;PR;127;52;179;290.502.793.296.089.000;709.497.206.703.910.000
3283;NILO PEÄANHA;BA;127;52;179;290.502.793.296.089.000;709.497.206.703.910.000
4061;PRESIDENTE VENCESLAU;SP;254;104;358;290.502.793.296.089.000;709.497.206.703.910.000
3622;PARANHOS;MS;127;52;179;290.502.793.296.089.000;709.497.206.703.910.000
3883;PIRES DO RIO;GO;171;70;241;290.456.431.535.269.000;709.543.568.464.730.000
665;BOCAIÈVA DO SUL;PR;171;70;241;290.456.431.535.269.000;709.543.568.464.730.000
1598;DOIS VIZINHOS;PR;193;79;272;290.441.176.470.588.000;709.558.823.529.411.000
801;BU÷QUE;PE;215;88;303;290.429.042.904.290.000;709.570.957.095.709.000
3761;PENHA;SC;215;88;303;290.429.042.904.290.000;709.570.957.095.709.000
4959;SAPê;PB;281;115;396;290.404.040.404.040.000;709.595.959.595.959.000
2225;INHUMAS;GO;303;124;427;290.398.126.463.700.000;709.601.873.536.299.000
1201;CATU÷PE;RS;66;27;93;290.322.580.645.161.000;709.677.419.354.838.000
728;BOQUIM;SE;154;63;217;290.322.580.645.161.000;709.677.419.354.838.000
1095;CARACOL;MS;88;36;124;290.322.580.645.161.000;709.677.419.354.838.000
343;ARARA;PB;88;36;124;290.322.580.645.161.000;709.677.419.354.838.000
3725;PEDRAN‡POLIS;SP;88;36;124;290.322.580.645.161.000;709.677.419.354.838.000
3894;PIUM;TO;110;45;155;290.322.580.645.161.000;709.677.419.354.838.000
3527;PAES LANDIM;PI;66;27;93;290.322.580.645.161.000;709.677.419.354.838.000
4535;SANTANA DO CARIRI;CE;88;36;124;290.322.580.645.161.000;709.677.419.354.838.000
2917;MANOEL VITORINO;BA;132;54;186;290.322.580.645.161.000;709.677.419.354.838.000
3011;MATA VERDE;MG;132;54;186;290.322.580.645.161.000;709.677.419.354.838.000
5569;VIT‡RIA BRASIL;SP;66;27;93;290.322.580.645.161.000;709.677.419.354.838.000
3176;MONTE SANTO DE MINAS;MG;181;74;255;290.196.078.431.372.000;709.803.921.568.627.000
2472;IVINHEMA;MS;181;74;255;290.196.078.431.372.000;709.803.921.568.627.000
3299;NOSSA SENHORA DAS DORES;SE;137;56;193;290.155.440.414.507.000;709.844.559.585.492.000
4305;RORAIN‡POLIS;RR;252;103;355;290.140.845.070.422.000;709.859.154.929.577.000
2765;LAURO MöLLER;SC;115;47;162;290.123.456.790.123.000;709.876.543.209.876.000
384;ARIQUEMES;RO;345;141;486;290.123.456.790.123.000;709.876.543.209.876.000
1136;CARMO DA CACHOEIRA;MG;230;94;324;290.123.456.790.123.000;709.876.543.209.876.000
987;CAMPO MAIOR;PI;230;94;324;290.123.456.790.123.000;709.876.543.209.876.000
1283;CIDEL∂NDIA;MA;115;47;162;290.123.456.790.123.000;709.876.543.209.876.000
2264;IPUEIRAS;CE;115;47;162;290.123.456.790.123.000;709.876.543.209.876.000
1933;GOIANµ;MG;115;47;162;290.123.456.790.123.000;709.876.543.209.876.000
2170;IGUARACI;PE;93;38;131;290.076.335.877.862.000;709.923.664.122.137.000
1466;CRISTAL∂NDIA;TO;93;38;131;290.076.335.877.862.000;709.923.664.122.137.000
1506;CUMARU;PE;93;38;131;290.076.335.877.862.000;709.923.664.122.137.000
421;ATALAIA;AL;186;76;262;290.076.335.877.862.000;709.923.664.122.137.000
313;ARAGOMINAS;TO;93;38;131;290.076.335.877.862.000;709.923.664.122.137.000
2674;JUSSARA;GO;186;76;262;290.076.335.877.862.000;709.923.664.122.137.000
4927;S«O SEBASTI«O DO CA÷;RS;186;76;262;290.076.335.877.862.000;709.923.664.122.137.000
5052;SERRAN‡POLIS DE MINAS;MG;93;38;131;290.076.335.877.862.000;709.923.664.122.137.000
4877;S«O MIGUEL DO PASSA QUATRO;GO;93;38;131;290.076.335.877.862.000;709.923.664.122.137.000
4952;S«O VICENTE;SP;722;295;1017;290.068.829.891.838.000;709.931.170.108.161.000
2356;ITAMBê;PE;257;105;362;290.055.248.618.784.000;709.944.751.381.215.000
371;AREIA BRANCA;RN;164;67;231;290.043.290.043.290.000;709.956.709.956.709.000
3362;NOVA MAMORê;RO;235;96;331;290.030.211.480.362.000;709.969.788.519.637.000
3262;NATIVIDADE;TO;142;58;200;290.000.000.000.000.000;710.000.000.000.000.000
3247;MURUTINGA DO SUL;SP;71;29;100;290.000.000.000.000.000;710.000.000.000.000.000
2615;JOAQUIM PIRES;PI;71;29;100;290.000.000.000.000.000;710.000.000.000.000.000
4358;SALTO DO LONTRA;PR;71;29;100;290.000.000.000.000.000;710.000.000.000.000.000
4508;SANTA TERESINHA;PB;71;29;100;290.000.000.000.000.000;710.000.000.000.000.000
3880;PIRATUBA;SC;71;29;100;290.000.000.000.000.000;710.000.000.000.000.000
304;ARACITABA;MG;71;29;100;290.000.000.000.000.000;710.000.000.000.000.000
1061;CAP«O DO CIP‡;RS;71;29;100;290.000.000.000.000.000;710.000.000.000.000.000
2081;HUGO NAPOLE«O;PI;71;29;100;290.000.000.000.000.000;710.000.000.000.000.000
4950;S«O VENDELINO;RS;71;29;100;290.000.000.000.000.000;710.000.000.000.000.000
2184;ILHêUS;BA;686;280;966;289.855.072.463.768.000;710.144.927.536.231.000
3879;PIRATININGA;SP;98;40;138;289.855.072.463.768.000;710.144.927.536.231.000
2752;LAPA;PR;196;80;276;289.855.072.463.768.000;710.144.927.536.231.000
2416;ITAQUARA;BA;98;40;138;289.855.072.463.768.000;710.144.927.536.231.000
5582;WAGNER;BA;98;40;138;289.855.072.463.768.000;710.144.927.536.231.000
2308;ITABUNA;BA;740;302;1042;289.827.255.278.310.000;710.172.744.721.689.000
4412;SANTA CRUZ DO RIO PARDO;SP;223;91;314;289.808.917.197.452.000;710.191.082.802.547.000
5304;TRACUNHAêM;PE;223;91;314;289.808.917.197.452.000;710.191.082.802.547.000
3751;PEIXE;TO;174;71;245;289.795.918.367.346.000;710.204.081.632.653.000
5349;TUMIRITINGA;MG;125;51;176;289.772.727.272.727.000;710.227.272.727.272.000
4132;RAUL SOARES;MG;277;113;390;289.743.589.743.589.000;710.256.410.256.410.000
4414;SANTA CRUZ DO XINGU;MT;76;31;107;289.719.626.168.224.000;710.280.373.831.775.000
2815;LUCêLIA;SP;228;93;321;289.719.626.168.224.000;710.280.373.831.775.000
2603;JO«O COSTA;PI;76;31;107;289.719.626.168.224.000;710.280.373.831.775.000
1690;EQUADOR;RN;76;31;107;289.719.626.168.224.000;710.280.373.831.775.000
1257;CHAPADA DOS GUIMAR«ES;MT;228;93;321;289.719.626.168.224.000;710.280.373.831.775.000
1285;CIP‡;BA;152;62;214;289.719.626.168.224.000;710.280.373.831.775.000
896;CAIUµ;SP;152;62;214;289.719.626.168.224.000;710.280.373.831.775.000
294;ARABUT«;SC;76;31;107;289.719.626.168.224.000;710.280.373.831.775.000
5536;VIEIR‡POLIS;PB;76;31;107;289.719.626.168.224.000;710.280.373.831.775.000
4775;S«O JOSê DA BOA VISTA;PR;76;31;107;289.719.626.168.224.000;710.280.373.831.775.000
3638;PARINTINS;AM;358;146;504;289.682.539.682.539.000;710.317.460.317.460.000
1998;GUAJARµ-MIRIM;RO;282;115;397;289.672.544.080.604.000;710.327.455.919.395.000
2228;INÈBIA PAULISTA;SP;103;42;145;289.655.172.413.793.000;710.344.827.586.206.000
1004;CAMPOS SALES;CE;103;42;145;289.655.172.413.793.000;710.344.827.586.206.000
3540;PALESTINA DO PARµ;PA;103;42;145;289.655.172.413.793.000;710.344.827.586.206.000
3855;PIRACURUCA;PI;103;42;145;289.655.172.413.793.000;710.344.827.586.206.000
4073;PROPRIµ;SE;206;84;290;289.655.172.413.793.000;710.344.827.586.206.000
2589;JERUMENHA;PI;103;42;145;289.655.172.413.793.000;710.344.827.586.206.000
3188;MONTIVIDIU DO NORTE;GO;103;42;145;289.655.172.413.793.000;710.344.827.586.206.000
4973;SARUTAIµ;SP;103;42;145;289.655.172.413.793.000;710.344.827.586.206.000
4894;S«O PEDRO DA UNI«O;MG;103;42;145;289.655.172.413.793.000;710.344.827.586.206.000
2956;MARCO;CE;130;53;183;289.617.486.338.797.000;710.382.513.661.202.000
4271;RIO TINTO;PB;130;53;183;289.617.486.338.797.000;710.382.513.661.202.000
5136;SUMIDOURO;RJ;130;53;183;289.617.486.338.797.000;710.382.513.661.202.000
2684;LADAINHA;MG;157;64;221;289.592.760.180.995.000;710.407.239.819.004.000
532;BARRA DO RIBEIRO;RS;184;75;259;289.575.289.575.289.000;710.424.710.424.710.000
4965;SAPUCAIA;RJ;184;75;259;289.575.289.575.289.000;710.424.710.424.710.000
5123;SORRISO;MT;292;119;411;289.537.712.895.377.000;710.462.287.104.622.000
555;BARRO DURO;PI;81;33;114;289.473.684.210.526.000;710.526.315.789.473.000
419;ASTORGA;PR;216;88;304;289.473.684.210.526.000;710.526.315.789.473.000
261;ANT‚NIO CARDOSO;BA;135;55;190;289.473.684.210.526.000;710.526.315.789.473.000
1011;CANANêIA;SP;243;99;342;289.473.684.210.526.000;710.526.315.789.473.000
1022;CANDEIAS;MG;135;55;190;289.473.684.210.526.000;710.526.315.789.473.000
1132;CARLOS CHAGAS;MG;216;88;304;289.473.684.210.526.000;710.526.315.789.473.000
2271;IRACEMA DO OESTE;PR;54;22;76;289.473.684.210.526.000;710.526.315.789.473.000
2267;IPUMIRIM;SC;81;33;114;289.473.684.210.526.000;710.526.315.789.473.000
1926;GL‡RIA DO GOITµ;PE;162;66;228;289.473.684.210.526.000;710.526.315.789.473.000
1716;ESP÷RITO SANTO DO DOURADO;MG;81;33;114;289.473.684.210.526.000;710.526.315.789.473.000
1798;FIGUEIR‡POLIS D'OESTE;MT;54;22;76;289.473.684.210.526.000;710.526.315.789.473.000
4473;SANTA MARIA DO TOCANTINS;TO;81;33;114;289.473.684.210.526.000;710.526.315.789.473.000
3805;PI“N;PR;243;99;342;289.473.684.210.526.000;710.526.315.789.473.000
3653;PASSA VINTE;MG;108;44;152;289.473.684.210.526.000;710.526.315.789.473.000
5282;TOBIAS BARRETO;SE;194;79;273;289.377.289.377.289.000;710.622.710.622.710.000
1472;CRISTINA;MG;167;68;235;289.361.702.127.659.000;710.638.297.872.340.000
1273;CHOR‡;CE;140;57;197;289.340.101.522.842.000;710.659.898.477.157.000
2208;INDIANA;SP;140;57;197;289.340.101.522.842.000;710.659.898.477.157.000
1064;CAPELA;AL;140;57;197;289.340.101.522.842.000;710.659.898.477.157.000
2527;JANDA÷RA;BA;140;57;197;289.340.101.522.842.000;710.659.898.477.157.000
2795;LIND‡IA;SP;113;46;159;289.308.176.100.628.000;710.691.823.899.371.000
3763;PEQUERI;MG;113;46;159;289.308.176.100.628.000;710.691.823.899.371.000
1068;CAPELA DO ALTO ALEGRE;BA;113;46;159;289.308.176.100.628.000;710.691.823.899.371.000
1766;FAZENDA RIO GRANDE;PR;452;184;636;289.308.176.100.628.000;710.691.823.899.371.000
4757;S«O JO«O DO SOTER;MA;199;81;280;289.285.714.285.714.000;710.714.285.714.285.000
4211;RIO ACIMA;MG;285;116;401;289.276.807.980.049.000;710.723.192.019.950.000
3096;MIRACEMA;RJ;285;116;401;289.276.807.980.049.000;710.723.192.019.950.000
3300;NOSSA SENHORA DAS GRAÄAS;PR;86;35;121;289.256.198.347.107.000;710.743.801.652.892.000
3510;OURO VERDE DO OESTE;PR;86;35;121;289.256.198.347.107.000;710.743.801.652.892.000
2266;IPUIÈNA;MG;86;35;121;289.256.198.347.107.000;710.743.801.652.892.000
830;CABECEIRAS DO PIAU÷;PI;86;35;121;289.256.198.347.107.000;710.743.801.652.892.000
748;BRAGANÄA;PA;403;164;567;289.241.622.574.955.000;710.758.377.425.044.000
1169;CASCAVEL;PR;779;317;1096;289.233.576.642.335.000;710.766.423.357.664.000
295;ARAÄAGI;PB;145;59;204;289.215.686.274.509.000;710.784.313.725.490.000
2727;LAGOA VERMELHA;RS;145;59;204;289.215.686.274.509.000;710.784.313.725.490.000
3366;NOVA MONTE VERDE;MT;118;48;166;289.156.626.506.024.000;710.843.373.493.975.000
4225;RIO CRESPO;RO;118;48;166;289.156.626.506.024.000;710.843.373.493.975.000
379;AR“S;RN;118;48;166;289.156.626.506.024.000;710.843.373.493.975.000
45;µGUA AZUL DO NORTE;PA;177;72;249;289.156.626.506.024.000;710.843.373.493.975.000
895;CAIRU;BA;177;72;249;289.156.626.506.024.000;710.843.373.493.975.000
4706;S«O GONÄALO DO RIO PRETO;MG;118;48;166;289.156.626.506.024.000;710.843.373.493.975.000
5581;VOTUPORANGA;SP;354;144;498;289.156.626.506.024.000;710.843.373.493.975.000
1823;FLORIAN‡POLIS;SC;740;301;1041;289.145.052.833.813.000;710.854.947.166.186.000
578;BELA VISTA DE MINAS;MG;209;85;294;289.115.646.258.503.000;710.884.353.741.496.000
3710;PEDRA AZUL;MG;209;85;294;289.115.646.258.503.000;710.884.353.741.496.000
646;BOA VIAGEM;CE;150;61;211;289.099.526.066.350.000;710.900.473.933.649.000
2403;ITµPOLIS;SP;241;98;339;289.085.545.722.713.000;710.914.454.277.286.000
4510;SANTA TEREZA DE GOIµS;GO;91;37;128;289.062.500.000.000.000;710.937.500.000.000.000
39;AFR∂NIO;PE;91;37;128;289.062.500.000.000.000;710.937.500.000.000.000
17;ACAJUTIBA;BA;182;74;256;289.062.500.000.000.000;710.937.500.000.000.000
1296;COCAL;PI;182;74;256;289.062.500.000.000.000;710.937.500.000.000.000
4963;SAPOPEMA;PR;91;37;128;289.062.500.000.000.000;710.937.500.000.000.000
2457;ITUIUTABA;MG;396;161;557;289.048.473.967.684.000;710.951.526.032.315.000
893;CAIC‡;RN;305;124;429;289.044.289.044.289.000;710.955.710.955.710.000
4886;S«O PAULO DE OLIVENÄA;AM;214;87;301;289.036.544.850.498.000;710.963.455.149.501.000
40;AFUµ;PA;123;50;173;289.017.341.040.462.000;710.982.658.959.537.000
3673;PATROC÷NIO;MG;369;150;519;289.017.341.040.462.000;710.982.658.959.537.000
3035;MATÂES;MA;155;63;218;288.990.825.688.073.000;711.009.174.311.926.000
2235;IPATINGA;MG;620;252;872;288.990.825.688.073.000;711.009.174.311.926.000
102;ALDEIAS ALTAS;MA;187;76;263;288.973.384.030.418.000;711.026.615.969.581.000
3343;NOVA FRIBURGO;RJ;657;267;924;288.961.038.961.038.000;711.038.961.038.961.000
2349;ITAMARANDIBA;MG;219;89;308;288.961.038.961.038.000;711.038.961.038.961.000
3148;MONTANHA;ES;160;65;225;288.888.888.888.888.000;711.111.111.111.111.000
3225;MUCURI;BA;384;156;540;288.888.888.888.888.000;711.111.111.111.111.000
4506;SANTA SALETE;SP;64;26;90;288.888.888.888.888.000;711.111.111.111.111.000
1031;C∂NDIDO SALES;BA;160;65;225;288.888.888.888.888.000;711.111.111.111.111.000
792;BRUMADINHO;MG;352;143;495;288.888.888.888.888.000;711.111.111.111.111.000
1939;GOIANINHA;RN;96;39;135;288.888.888.888.888.000;711.111.111.111.111.000
5146;TABIRA;PE;128;52;180;288.888.888.888.888.000;711.111.111.111.111.000
4324;SABARµ;MG;645;262;907;288.864.388.092.613.000;711.135.611.907.386.000
453;BADY BASSITT;SP;165;67;232;288.793.103.448.275.000;711.206.896.551.724.000
4150;REM÷GIO;PB;133;54;187;288.770.053.475.935.000;711.229.946.524.064.000
2485;JACARACI;BA;133;54;187;288.770.053.475.935.000;711.229.946.524.064.000
2760;LARANJEIRAS DO SUL;PR;266;108;374;288.770.053.475.935.000;711.229.946.524.064.000
3633;PARDINHO;SP;101;41;142;288.732.394.366.197.000;711.267.605.633.802.000
376;AREI‡POLIS;SP;202;82;284;288.732.394.366.197.000;711.267.605.633.802.000
2051;GUATAPARµ;SP;202;82;284;288.732.394.366.197.000;711.267.605.633.802.000
1237;CERRITO;RS;101;41;142;288.732.394.366.197.000;711.267.605.633.802.000
5264;TIBAU DO SUL;RN;101;41;142;288.732.394.366.197.000;711.267.605.633.802.000
5215;TARUMIRIM;MG;101;41;142;288.732.394.366.197.000;711.267.605.633.802.000
4452;SANTA LUZIA DO ITANHY;SE;170;69;239;288.702.928.870.292.000;711.297.071.129.707.000
1498;CUBAT«O;SP;446;181;627;288.676.236.044.657.000;711.323.763.955.342.000
1253;CHAPADA;RS;69;28;97;288.659.793.814.432.000;711.340.206.185.567.000
2188;IMACULADA;PB;69;28;97;288.659.793.814.432.000;711.340.206.185.567.000
2196;IMIGRANTE;RS;69;28;97;288.659.793.814.432.000;711.340.206.185.567.000
248;ANHANGöERA;GO;69;28;97;288.659.793.814.432.000;711.340.206.185.567.000
3514;PACAEMBU;SP;138;56;194;288.659.793.814.432.000;711.340.206.185.567.000
3749;PEDRO TEIXEIRA;MG;69;28;97;288.659.793.814.432.000;711.340.206.185.567.000
2648;JÈLIO MESQUITA;SP;69;28;97;288.659.793.814.432.000;711.340.206.185.567.000
2595;JIQUIRIÄµ;BA;138;56;194;288.659.793.814.432.000;711.340.206.185.567.000
2996;MARTIN‡POLIS;SP;276;112;388;288.659.793.814.432.000;711.340.206.185.567.000
2988;MARIZ‡POLIS;PB;69;28;97;288.659.793.814.432.000;711.340.206.185.567.000
5450;VALE DO ANARI;RO;138;56;194;288.659.793.814.432.000;711.340.206.185.567.000
1337;CONCEIÄ«O DA FEIRA;BA;244;99;343;288.629.737.609.329.000;711.370.262.390.670.000
1874;FREI PAULO;SE;106;43;149;288.590.604.026.845.000;711.409.395.973.154.000
3524;PADRE CARVALHO;MG;106;43;149;288.590.604.026.845.000;711.409.395.973.154.000
4981;SAÈDE;BA;106;43;149;288.590.604.026.845.000;711.409.395.973.154.000
2966;MARIA HELENA;PR;143;58;201;288.557.213.930.348.000;711.442.786.069.651.000
1588;DIVISA NOVA;MG;143;58;201;288.557.213.930.348.000;711.442.786.069.651.000
998;CAMPOS DO JORD«O;SP;429;174;603;288.557.213.930.348.000;711.442.786.069.651.000
1728;ESTRELA;RS;254;103;357;288.515.406.162.464.000;711.484.593.837.535.000
5106;SOBRADINHO;BA;254;103;357;288.515.406.162.464.000;711.484.593.837.535.000
957;CAMPINAS;SP;1640;665;2305;288.503.253.796.095.000;711.496.746.203.904.000
702;BOM PROGRESSO;RS;74;30;104;288.461.538.461.538.000;711.538.461.538.461.000
341;ARAPUTANGA;MT;185;75;260;288.461.538.461.538.000;711.538.461.538.461.000
1381;CONTENDAS DO SINCORµ;BA;74;30;104;288.461.538.461.538.000;711.538.461.538.461.000
1258;CHAPADA GAÈCHA;MG;148;60;208;288.461.538.461.538.000;711.538.461.538.461.000
2853;MACED‚NIA;SP;74;30;104;288.461.538.461.538.000;711.538.461.538.461.000
3818;PINDA÷;BA;74;30;104;288.461.538.461.538.000;711.538.461.538.461.000
3994;PORTO MURTINHO;MS;185;75;260;288.461.538.461.538.000;711.538.461.538.461.000
5273;TIMB‡;SC;148;60;208;288.461.538.461.538.000;711.538.461.538.461.000
1858;FRANCISCO BELTR«O;PR;227;92;319;288.401.253.918.495.000;711.598.746.081.504.000
797;BUEN‡POLIS;MG;190;77;267;288.389.513.108.614.000;711.610.486.891.385.000
4112;QUITANDINHA;PR;190;77;267;288.389.513.108.614.000;711.610.486.891.385.000
5076;SEVER÷NIA;SP;190;77;267;288.389.513.108.614.000;711.610.486.891.385.000
3664;PASSOS;MG;306;124;430;288.372.093.023.255.000;711.627.906.976.744.000
1496;CRUZ÷LIA;MG;153;62;215;288.372.093.023.255.000;711.627.906.976.744.000
1293;CLEVEL∂NDIA;PR;116;47;163;288.343.558.282.208.000;711.656.441.717.791.000
450;BACABEIRA;MA;195;79;274;288.321.167.883.211.000;711.678.832.116.788.000
1455;CRATO;CE;432;175;607;288.303.130.148.270.000;711.696.869.851.729.000
2137;IBITURUNA;MG;79;32;111;288.288.288.288.288.000;711.711.711.711.711.000
1025;CANDIBA;BA;79;32;111;288.288.288.288.288.000;711.711.711.711.711.000
3566;PALMELO;GO;79;32;111;288.288.288.288.288.000;711.711.711.711.711.000
5107;SOBRADINHO;RS;79;32;111;288.288.288.288.288.000;711.711.711.711.711.000
5485;VµRZEA DA ROÄA;BA;79;32;111;288.288.288.288.288.000;711.711.711.711.711.000
985;CAMPO LIMPO PAULISTA;SP;358;145;503;288.270.377.733.598.000;711.729.622.266.401.000
817;BURITIS;MG;200;81;281;288.256.227.758.007.000;711.743.772.241.992.000
4585;SANTO ANT‚NIO DO IÄµ;AM;200;81;281;288.256.227.758.007.000;711.743.772.241.992.000
5241;TEOT‚NIO VILELA;AL;200;81;281;288.256.227.758.007.000;711.743.772.241.992.000
1036;CANGUARETAMA;RN;242;98;340;288.235.294.117.647.000;711.764.705.882.352.000
3217;MOSTARDAS;RS;121;49;170;288.235.294.117.647.000;711.764.705.882.352.000
5164;TAIPU;RN;121;49;170;288.235.294.117.647.000;711.764.705.882.352.000
2947;MARAÈ;BA;163;66;229;288.209.606.986.899.000;711.790.393.013.100.000
2223;INHAÈMA;MG;163;66;229;288.209.606.986.899.000;711.790.393.013.100.000
1705;ESPERANÄA;PB;163;66;229;288.209.606.986.899.000;711.790.393.013.100.000
3166;MONTE CARMELO;MG;247;100;347;288.184.438.040.345.000;711.815.561.959.654.000
3288;NIPO«;SP;126;51;177;288.135.593.220.338.000;711.864.406.779.661.000
3359;NOVA LIMA;MG;378;153;531;288.135.593.220.338.000;711.864.406.779.661.000
3054;MEDEIROS NETO;BA;126;51;177;288.135.593.220.338.000;711.864.406.779.661.000
2605;JO«O DOURADO;BA;84;34;118;288.135.593.220.338.000;711.864.406.779.661.000
2625;JOSê DA PENHA;RN;42;17;59;288.135.593.220.338.000;711.864.406.779.661.000
2529;JANDIRA;SP;504;204;708;288.135.593.220.338.000;711.864.406.779.661.000
876;CAETê;MG;388;157;545;288.073.394.495.412.000;711.926.605.504.587.000
2994;MARTINHO CAMPOS;MG;173;70;243;288.065.843.621.399.000;711.934.156.378.600.000
662;BOCAINA DE MINAS;MG;131;53;184;288.043.478.260.869.000;711.956.521.739.130.000
1837;FORMOSO;MG;131;53;184;288.043.478.260.869.000;711.956.521.739.130.000
1231;CENTRO DO GUILHERME;MA;131;53;184;288.043.478.260.869.000;711.956.521.739.130.000
2322;ITAGUA÷;RJ;487;197;684;288.011.695.906.432.000;711.988.304.093.567.000
3822;PINDOBAÄU;BA;178;72;250;288.000.000.000.000.000;712.000.000.000.000.000
3748;PEDRO RêGIS;PB;89;36;125;288.000.000.000.000.000;712.000.000.000.000.000
1807;FLORA÷;PR;89;36;125;288.000.000.000.000.000;712.000.000.000.000.000
969;CAMPO BOM;RS;267;108;375;288.000.000.000.000.000;712.000.000.000.000.000
568;BATAYPOR«;MS;89;36;125;288.000.000.000.000.000;712.000.000.000.000.000
1815;FLORESTA;PE;136;55;191;287.958.115.183.246.000;712.041.884.816.753.000
3639;PARIPIRANGA;BA;136;55;191;287.958.115.183.246.000;712.041.884.816.753.000
2670;JURUENA;MT;136;55;191;287.958.115.183.246.000;712.041.884.816.753.000
769;BREJETUBA;ES;183;74;257;287.937.743.190.661.000;712.062.256.809.338.000
5390;UBATUBA;SP;465;188;653;287.901.990.811.638.000;712.098.009.188.361.000
922;CAMACHO;MG;94;38;132;287.878.787.878.787.000;712.121.212.121.212.000
3109;MIRANORTE;TO;141;57;198;287.878.787.878.787.000;712.121.212.121.212.000
4407;SANTA CRUZ DE SALINAS;MG;94;38;132;287.878.787.878.787.000;712.121.212.121.212.000
5208;TAQUARUÄU DO SUL;RS;47;19;66;287.878.787.878.787.000;712.121.212.121.212.000
4655;S«O DOMINGOS DO PRATA;MG;188;76;264;287.878.787.878.787.000;712.121.212.121.212.000
4968;SAQUAREMA;RJ;428;173;601;287.853.577.371.048.000;712.146.422.628.951.000
549;BARREIROS;PE;240;97;337;287.833.827.893.175.000;712.166.172.106.824.000
3784;PESQUEIRA;PE;339;137;476;287.815.126.050.420.000;712.184.873.949.579.000
3023;MATINHA;MA;146;59;205;287.804.878.048.780.000;712.195.121.951.219.000
1678;ENGENHEIRO NAVARRO;MG;146;59;205;287.804.878.048.780.000;712.195.121.951.219.000
3890;PITANGUEIRAS;SP;245;99;344;287.790.697.674.418.000;712.209.302.325.581.000
3543;PALMA;MG;99;40;139;287.769.784.172.661.000;712.230.215.827.338.000
3342;NOVA FLORESTA;PB;99;40;139;287.769.784.172.661.000;712.230.215.827.338.000
1914;GENERAL SAMPAIO;CE;99;40;139;287.769.784.172.661.000;712.230.215.827.338.000
4726;S«O JO«O DA PONTE;MG;198;80;278;287.769.784.172.661.000;712.230.215.827.338.000
2857;MACHADINHO DO OESTE;RO;250;101;351;287.749.287.749.287.000;712.250.712.250.712.000
4203;RIBEIR«O PRETO;SP;1057;427;1484;287.735.849.056.603.000;712.264.150.943.396.000
4627;S«O BERNARDO;MA;151;61;212;287.735.849.056.603.000;712.264.150.943.396.000
3926;POJUCA;BA;354;143;497;287.726.358.148.893.000;712.273.641.851.106.000
3076;MIGUEL‡POLIS;SP;203;82;285;287.719.298.245.614.000;712.280.701.754.385.000
3175;MONTE SANTO;BA;255;103;358;287.709.497.206.703.000;712.290.502.793.296.000
2025;GUARANêSIA;MG;255;103;358;287.709.497.206.703.000;712.290.502.793.296.000
383;ARIPUAN«;MT;156;63;219;287.671.232.876.712.000;712.328.767.123.287.000
163;ALTO PARNA÷BA;MA;156;63;219;287.671.232.876.712.000;712.328.767.123.287.000
658;BOCA DA MATA;AL;156;63;219;287.671.232.876.712.000;712.328.767.123.287.000
3111;MIRANTE DA SERRA;RO;156;63;219;287.671.232.876.712.000;712.328.767.123.287.000
2286;IRAUÄUBA;CE;156;63;219;287.671.232.876.712.000;712.328.767.123.287.000
3947;PONTE BRANCA;MT;52;21;73;287.671.232.876.712.000;712.328.767.123.287.000
3811;PILÂES;RN;52;21;73;287.671.232.876.712.000;712.328.767.123.287.000
4241;RIO DOS BOIS;TO;104;42;146;287.671.232.876.712.000;712.328.767.123.287.000
4105;QUINJINGUE;BA;104;42;146;287.671.232.876.712.000;712.328.767.123.287.000
4511;SANTA TEREZA DO OESTE;PR;156;63;219;287.671.232.876.712.000;712.328.767.123.287.000
4924;S«O SEBASTI«O DE LAGOA DE ROÄA;PB;104;42;146;287.671.232.876.712.000;712.328.767.123.287.000
2777;LENÄ‡IS PAULISTA;SP;327;132;459;287.581.699.346.405.000;712.418.300.653.594.000
2492;JACIARA;MT;166;67;233;287.553.648.068.669.000;712.446.351.931.330.000
4691;S«O GABRIEL DA CACHOEIRA;AM;280;113;393;287.531.806.615.776.000;712.468.193.384.223.000
1084;CAPIT«O LE‚NIDAS MARQUES;PR;114;46;160;287.500.000.000.000.000;712.500.000.000.000.000
391;AROEIRAS;PB;114;46;160;287.500.000.000.000.000;712.500.000.000.000.000
4798;S«O JOSê DO CALÄADO;ES;171;69;240;287.500.000.000.000.000;712.500.000.000.000.000
5391;UBERABA;MG;570;230;800;287.500.000.000.000.000;712.500.000.000.000.000
5522;VIANA;ES;285;115;400;287.500.000.000.000.000;712.500.000.000.000.000
1073;CAPIM BRANCO;MG;176;71;247;287.449.392.712.550.000;712.550.607.287.449.000
2098;IBATIBA;ES;176;71;247;287.449.392.712.550.000;712.550.607.287.449.000
1768;FEIJ‡;AC;176;71;247;287.449.392.712.550.000;712.550.607.287.449.000
925;CAMANDUCAIA;MG;238;96;334;287.425.149.700.598.000;712.574.850.299.401.000
3404;NOVA UNI«O;RO;119;48;167;287.425.149.700.598.000;712.574.850.299.401.000
5521;VIANA;MA;238;96;334;287.425.149.700.598.000;712.574.850.299.401.000
3170;MONTE DO CARMO;TO;186;75;261;287.356.321.839.080.000;712.643.678.160.919.000
3271;NAZARê PAULISTA;SP;248;100;348;287.356.321.839.080.000;712.643.678.160.919.000
4296;RONDA ALTA;RS;62;25;87;287.356.321.839.080.000;712.643.678.160.919.000
1048;CANTAGALO;MG;124;50;174;287.356.321.839.080.000;712.643.678.160.919.000
736;BOREBI;SP;124;50;174;287.356.321.839.080.000;712.643.678.160.919.000
1944;GOIATUBA;GO;248;100;348;287.356.321.839.080.000;712.643.678.160.919.000
5021;SERICITA;MG;62;25;87;287.356.321.839.080.000;712.643.678.160.919.000
443;AVEIRO;PA;191;77;268;287.313.432.835.820.000;712.686.567.164.179.000
4693;S«O GABRIEL DO OESTE;MS;191;77;268;287.313.432.835.820.000;712.686.567.164.179.000
3;ABAETê;MG;129;52;181;287.292.817.679.558.000;712.707.182.320.441.000
2096;IBATê;SP;258;104;362;287.292.817.679.558.000;712.707.182.320.441.000
1371;CONGONHINHAS;PR;129;52;181;287.292.817.679.558.000;712.707.182.320.441.000
2981;MARINGµ;PR;650;262;912;287.280.701.754.385.000;712.719.298.245.614.000
3466;OLINDINA;BA;196;79;275;287.272.727.272.727.000;712.727.272.727.272.000
3198;MORRINHOS;GO;268;108;376;287.234.042.553.191.000;712.765.957.446.808.000
4785;S«O JOSê DAS PALMEIRAS;PR;67;27;94;287.234.042.553.191.000;712.765.957.446.808.000
5006;SENADOR LA ROCQUE;MA;134;54;188;287.234.042.553.191.000;712.765.957.446.808.000
5352;TUNAS DO PARANµ;PR;134;54;188;287.234.042.553.191.000;712.765.957.446.808.000
1097;CARAGUATATUBA;SP;546;220;766;287.206.266.318.537.000;712.793.733.681.462.000
1565;DIAMANTINA;MG;345;139;484;287.190.082.644.628.000;712.809.917.355.371.000
3840;PINHEIRO MACHADO;RS;139;56;195;287.179.487.179.487.000;712.820.512.820.512.000
5048;SERRANA;SP;422;170;592;287.162.162.162.162.000;712.837.837.837.837.000
3941;PONTALINDA;SP;72;29;101;287.128.712.871.287.000;712.871.287.128.712.000
4323;RUY BARBOSA;RN;72;29;101;287.128.712.871.287.000;712.871.287.128.712.000
4023;PRAD‡POLIS;SP;216;87;303;287.128.712.871.287.000;712.871.287.128.712.000
3221;MUCAJA÷;RR;216;87;303;287.128.712.871.287.000;712.871.287.128.712.000
3326;NOVA CANA« PAULISTA;SP;72;29;101;287.128.712.871.287.000;712.871.287.128.712.000
2850;MACAU;RN;216;87;303;287.128.712.871.287.000;712.871.287.128.712.000
757;BRASIL∂NDIA DO SUL;PR;72;29;101;287.128.712.871.287.000;712.871.287.128.712.000
51;µGUA BRANCA DO AMAPARI;AP;72;29;101;287.128.712.871.287.000;712.871.287.128.712.000
5362;TUPARETAMA;PE;72;29;101;287.128.712.871.287.000;712.871.287.128.712.000
2800;LINS;SP;365;147;512;287.109.375.000.000.000;712.890.625.000.000.000
322;ARAGUARI;MG;442;178;620;287.096.774.193.548.000;712.903.225.806.451.000
1882;FUND«O;ES;221;89;310;287.096.774.193.548.000;712.903.225.806.451.000
2048;GUARUJµ DO SUL;SC;77;31;108;287.037.037.037.037.000;712.962.962.962.962.000
2565;JATAIZINHO;PR;154;62;216;287.037.037.037.037.000;712.962.962.962.962.000
3332;NOVA CRUZ;RN;154;62;216;287.037.037.037.037.000;712.962.962.962.962.000
4032;PRATA DO PIAU÷;PI;77;31;108;287.037.037.037.037.000;712.962.962.962.962.000
4278;RITµPOLIS;MG;154;62;216;287.037.037.037.037.000;712.962.962.962.962.000
5368;TURIL∂NDIA;MA;231;93;324;287.037.037.037.037.000;712.962.962.962.962.000
5404;UMBAÈBA;SE;154;62;216;287.037.037.037.037.000;712.962.962.962.962.000
5441;URUOCA;CE;77;31;108;287.037.037.037.037.000;712.962.962.962.962.000
5596;XAPURI;AC;154;62;216;287.037.037.037.037.000;712.962.962.962.962.000
4953;S«O VICENTE DE MINAS;MG;77;31;108;287.037.037.037.037.000;712.962.962.962.962.000
225;ANASTµCIO;MS;236;95;331;287.009.063.444.108.000;712.990.936.555.891.000
2861;MACUCO;RJ;159;64;223;286.995.515.695.067.000;713.004.484.304.932.000
571;BAYEUX;PB;564;227;791;286.978.508.217.446.000;713.021.491.782.553.000
2930;MARACAJµ;SC;82;33;115;286.956.521.739.130.000;713.043.478.260.869.000
2330;ITAIÄABA;CE;82;33;115;286.956.521.739.130.000;713.043.478.260.869.000
4013;POTIRETAMA;CE;82;33;115;286.956.521.739.130.000;713.043.478.260.869.000
4608;SANTO INµCIO;PR;82;33;115;286.956.521.739.130.000;713.043.478.260.869.000
3475;ORAT‡RIOS;MG;169;68;237;286.919.831.223.628.000;713.080.168.776.371.000
813;BURITICUPU;MA;169;68;237;286.919.831.223.628.000;713.080.168.776.371.000
4970;SARANDI;PR;338;136;474;286.919.831.223.628.000;713.080.168.776.371.000
739;BOTELHOS;MG;256;103;359;286.908.077.994.428.000;713.091.922.005.571.000
883;CAFEZAL DO SUL;PR;87;35;122;286.885.245.901.639.000;713.114.754.098.360.000
34;ADUSTINA;BA;87;35;122;286.885.245.901.639.000;713.114.754.098.360.000
4270;RIO SONO;TO;87;35;122;286.885.245.901.639.000;713.114.754.098.360.000
4340;SALGADO;SE;174;70;244;286.885.245.901.639.000;713.114.754.098.360.000
2862;MACURURê;BA;87;35;122;286.885.245.901.639.000;713.114.754.098.360.000
2909;MANGUEIRINHA;PR;174;70;244;286.885.245.901.639.000;713.114.754.098.360.000
216;ANAJµS;PA;179;72;251;286.852.589.641.434.000;713.147.410.358.565.000
2348;ITAMARAJU;BA;363;146;509;286.836.935.166.994.000;713.163.064.833.005.000
2842;MACAJUBA;BA;92;37;129;286.821.705.426.356.000;713.178.294.573.643.000
3424;NOVO HORIZONTE DO NORTE;MT;92;37;129;286.821.705.426.356.000;713.178.294.573.643.000
3950;PONTE SERRADA;SC;92;37;129;286.821.705.426.356.000;713.178.294.573.643.000
3953;PONTO BELO;ES;92;37;129;286.821.705.426.356.000;713.178.294.573.643.000
1833;FORMOSA DO OESTE;PR;92;37;129;286.821.705.426.356.000;713.178.294.573.643.000
1566;DIAMANTINO;MT;184;74;258;286.821.705.426.356.000;713.178.294.573.643.000
1641;DUARTINA;SP;189;76;265;286.792.452.830.188.000;713.207.547.169.811.000
4874;S«O MIGUEL DO GUAPORê;RO;189;76;265;286.792.452.830.188.000;713.207.547.169.811.000
3968;PORTEL;PA;291;117;408;286.764.705.882.352.000;713.235.294.117.647.000
4896;S«O PEDRO DE ALC∂NTARA;SC;97;39;136;286.764.705.882.352.000;713.235.294.117.647.000
1387;CORAÄ«O DE MARIA;BA;199;80;279;286.738.351.254.480.000;713.261.648.745.519.000
132;ALTA FLORESTA;MT;204;82;286;286.713.286.713.286.000;713.286.713.286.713.000
3005;MASSARANDUBA;SC;102;41;143;286.713.286.713.286.000;713.286.713.286.713.000
5302;TRABIJU;SP;102;41;143;286.713.286.713.286.000;713.286.713.286.713.000
935;CAMBUCI;RJ;209;84;293;286.689.419.795.221.000;713.310.580.204.778.000
963;CAMPO ALEGRE DE GOIµS;GO;107;43;150;286.666.666.666.666.000;713.333.333.333.333.000
1603;DOM CAVATI;MG;107;43;150;286.666.666.666.666.000;713.333.333.333.333.000
5452;VALE DO SOL;RS;107;43;150;286.666.666.666.666.000;713.333.333.333.333.000
104;ALEGRE;ES;219;88;307;286.644.951.140.065.000;713.355.048.859.934.000
4524;SANTANA;AP;443;178;621;286.634.460.547.504.000;713.365.539.452.495.000
4334;SALES;SP;112;45;157;286.624.203.821.656.000;713.375.796.178.343.000
3031;MATO LEIT«O;RS;112;45;157;286.624.203.821.656.000;713.375.796.178.343.000
2903;MANDAGUARI;PR;224;90;314;286.624.203.821.656.000;713.375.796.178.343.000
1454;CRATEÈS;CE;229;92;321;286.604.361.370.716.000;713.395.638.629.283.000
4083;QUARTEL GERAL;MG;117;47;164;286.585.365.853.658.000;713.414.634.146.341.000
3803;PIEDADE DO RIO GRANDE;MG;117;47;164;286.585.365.853.658.000;713.414.634.146.341.000
550;BARRETOS;SP;473;190;663;286.576.168.929.110.000;713.423.831.070.889.000
1145;CARM‡POLIS DE MINAS;MG;122;49;171;286.549.707.602.339.000;713.450.292.397.660.000
3449;OEIRAS;PI;122;49;171;286.549.707.602.339.000;713.450.292.397.660.000
2351;ITAMARATI DE MINAS;MG;122;49;171;286.549.707.602.339.000;713.450.292.397.660.000
5373;TURURU;CE;122;49;171;286.549.707.602.339.000;713.450.292.397.660.000
3621;PARANAVA÷;PR;254;102;356;286.516.853.932.584.000;713.483.146.067.415.000
3842;PINHEIROS;ES;254;102;356;286.516.853.932.584.000;713.483.146.067.415.000
24;ACOPIARA;CE;127;51;178;286.516.853.932.584.000;713.483.146.067.415.000
2838;LUZIL∂NDIA;PI;132;53;185;286.486.486.486.486.000;713.513.513.513.513.000
2830;LUMINµRIAS;MG;132;53;185;286.486.486.486.486.000;713.513.513.513.513.000
5165;TAIÈVA;SP;132;53;185;286.486.486.486.486.000;713.513.513.513.513.000
5095;SINIMBU;RS;132;53;185;286.486.486.486.486.000;713.513.513.513.513.000
5137;SURUBIM;PE;264;106;370;286.486.486.486.486.000;713.513.513.513.513.000
5243;TERESINA;PI;1091;438;1529;286.461.739.699.149.000;713.538.260.300.850.000
3180;MONTEIRO LOBATO;SP;137;55;192;286.458.333.333.333.000;713.541.666.666.666.000
886;CAIAP‚NIA;GO;137;55;192;286.458.333.333.333.000;713.541.666.666.666.000
5239;TE‡FILO OTONI;MG;548;220;768;286.458.333.333.333.000;713.541.666.666.666.000
336;ARAPONGAS;PR;421;169;590;286.440.677.966.101.000;713.559.322.033.898.000
1550;DEODµPOLIS;MS;142;57;199;286.432.160.804.020.000;713.567.839.195.979.000
3168;MONTE CASTELO;SC;142;57;199;286.432.160.804.020.000;713.567.839.195.979.000
3112;MIRANTE DO PARANAPANEMA;SP;147;59;206;286.407.766.990.291.000;713.592.233.009.708.000
1793;FERROS;MG;147;59;206;286.407.766.990.291.000;713.592.233.009.708.000
1955;GOVERNADOR DIX-SEPT ROSADO;RN;147;59;206;286.407.766.990.291.000;713.592.233.009.708.000
2092;IATI;PE;147;59;206;286.407.766.990.291.000;713.592.233.009.708.000
2047;GUARUJµ;SP;770;309;1079;286.376.274.328.081.000;713.623.725.671.918.000
3275;NAZµRIO;GO;157;63;220;286.363.636.363.636.000;713.636.363.636.363.000
509;BARRA;BA;162;65;227;286.343.612.334.801.000;713.656.387.665.198.000
5487;VµRZEA GRANDE;MT;663;266;929;286.329.386.437.029.000;713.670.613.562.970.000
1463;CRISTAIS PAULISTA;SP;167;67;234;286.324.786.324.786.000;713.675.213.675.213.000
4216;RIO BONITO DO IGUAÄU;PR;172;69;241;286.307.053.941.908.000;713.692.946.058.091.000
4577;SANTO ANT‚NIO DE PµDUA;RJ;359;144;503;286.282.306.163.021.000;713.717.693.836.978.000
995;CAMPOS BELOS;GO;182;73;255;286.274.509.803.921.000;713.725.490.196.078.000
2367;ITAOBIM;MG;192;77;269;286.245.353.159.851.000;713.754.646.840.148.000
4935;S«O SEBASTI«O DO UATUM«;AM;197;79;276;286.231.884.057.971.000;713.768.115.942.028.000
2793;LIMOEIRO DO NORTE;CE;212;85;297;286.195.286.195.286.000;713.804.713.804.713.000
5184;TAPAUµ;AM;227;91;318;286.163.522.012.578.000;713.836.477.987.421.000
4119;QUIXERAMOBIM;CE;232;93;325;286.153.846.153.846.000;713.846.153.846.153.000
5473;VARGEM GRANDE DO SUL;SP;242;97;339;286.135.693.215.339.000;713.864.306.784.660.000
2707;LAGOA DO CARRO;PE;247;99;346;286.127.167.630.057.000;713.872.832.369.942.000
1893;GANDU;BA;277;111;388;286.082.474.226.804.000;713.917.525.773.195.000
2052;GUAXUPê;MG;337;135;472;286.016.949.152.542.000;713.983.050.847.457.000
5096;SINOP;MT;352;141;493;286.004.056.795.131.000;713.995.943.204.868.000
2033;GUARAPARI;ES;500;200;700;285.714.285.714.285.000;714.285.714.285.714.000
2094;IBARAMA;RS;60;24;84;285.714.285.714.285.000;714.285.714.285.714.000
2131;IBIRUBµ;RS;100;40;140;285.714.285.714.285.000;714.285.714.285.714.000
2108;IBICARA÷;BA;240;96;336;285.714.285.714.285.000;714.285.714.285.714.000
2214;INDIAVA÷;MT;95;38;133;285.714.285.714.285.000;714.285.714.285.714.000
2262;IPUBI;PE;115;46;161;285.714.285.714.285.000;714.285.714.285.714.000
1891;GAMELEIRA DE GOIµS;GO;155;62;217;285.714.285.714.285.000;714.285.714.285.714.000
1864;FRANCISCO SANTOS;PI;55;22;77;285.714.285.714.285.000;714.285.714.285.714.000
1959;GOVERNADOR LINDENBERG;ES;165;66;231;285.714.285.714.285.000;714.285.714.285.714.000
1797;FIGUEIR‡POLIS;TO;60;24;84;285.714.285.714.285.000;714.285.714.285.714.000
1818;FLORESTA DO PIAU÷;PI;55;22;77;285.714.285.714.285.000;714.285.714.285.714.000
1782;F“NIX;PR;100;40;140;285.714.285.714.285.000;714.285.714.285.714.000
1495;CRUZETA;RN;55;22;77;285.714.285.714.285.000;714.285.714.285.714.000
1522;CURRAL DE CIMA;PB;70;28;98;285.714.285.714.285.000;714.285.714.285.714.000
1232;CENTRO NOVO DO MARANH«O;MA;100;40;140;285.714.285.714.285.000;714.285.714.285.714.000
910;CALÄOENE;AP;155;62;217;285.714.285.714.285.000;714.285.714.285.714.000
1144;CARM‡POLIS;SE;165;66;231;285.714.285.714.285.000;714.285.714.285.714.000
1078;CAPISTRANO;CE;170;68;238;285.714.285.714.285.000;714.285.714.285.714.000
723;BONITO DE SANTA Fê;PB;75;30;105;285.714.285.714.285.000;714.285.714.285.714.000
762;BRASNORTE;MT;160;64;224;285.714.285.714.285.000;714.285.714.285.714.000
835;CABO VERDE;MG;145;58;203;285.714.285.714.285.000;714.285.714.285.714.000
353;ARARUNA;PB;90;36;126;285.714.285.714.285.000;714.285.714.285.714.000
31;ADEL∂NDIA;GO;80;32;112;285.714.285.714.285.000;714.285.714.285.714.000
1;ABADIA DOS DOURADOS;MG;95;38;133;285.714.285.714.285.000;714.285.714.285.714.000
5;ABAIARA;CE;55;22;77;285.714.285.714.285.000;714.285.714.285.714.000
94;ALAGOINHAS;BA;555;222;777;285.714.285.714.285.000;714.285.714.285.714.000
75;µGUAS VERMELHAS;MG;120;48;168;285.714.285.714.285.000;714.285.714.285.714.000
87;ALAGOA;MG;65;26;91;285.714.285.714.285.000;714.285.714.285.714.000
276;APARECIDA DO TABOADO;MS;215;86;301;285.714.285.714.285.000;714.285.714.285.714.000
2784;LIC÷NIO DE ALMEIDA;BA;100;40;140;285.714.285.714.285.000;714.285.714.285.714.000
2811;LORETO;MA;80;32;112;285.714.285.714.285.000;714.285.714.285.714.000
2812;LOURDES;SP;95;38;133;285.714.285.714.285.000;714.285.714.285.714.000
2706;LAGOA DO BARRO DO PIAU÷;PI;60;24;84;285.714.285.714.285.000;714.285.714.285.714.000
2629;JOSEL∂NDIA;MA;75;30;105;285.714.285.714.285.000;714.285.714.285.714.000
2614;JOAQUIM NABUCO;PE;180;72;252;285.714.285.714.285.000;714.285.714.285.714.000
2596;JITAÈNA;BA;140;56;196;285.714.285.714.285.000;714.285.714.285.714.000
2315;ITACURUBI;RS;80;32;112;285.714.285.714.285.000;714.285.714.285.714.000
2495;JACOBINA;BA;305;122;427;285.714.285.714.285.000;714.285.714.285.714.000
2439;ITAUÄU;GO;115;46;161;285.714.285.714.285.000;714.285.714.285.714.000
3265;NAVEGANTES;SC;225;90;315;285.714.285.714.285.000;714.285.714.285.714.000
3386;NOVA REDENÄ«O;BA;80;32;112;285.714.285.714.285.000;714.285.714.285.714.000
3294;NORDESTINA;BA;110;44;154;285.714.285.714.285.000;714.285.714.285.714.000
2999;MARUIM;SE;130;52;182;285.714.285.714.285.000;714.285.714.285.714.000
3043;MATUTINA;MG;75;30;105;285.714.285.714.285.000;714.285.714.285.714.000
4125;RAMIL∂NDIA;PR;115;46;161;285.714.285.714.285.000;714.285.714.285.714.000
4076;PRUDENT‡POLIS;PR;275;110;385;285.714.285.714.285.000;714.285.714.285.714.000
4100;QUELUZITO;MG;80;32;112;285.714.285.714.285.000;714.285.714.285.714.000
4236;RIO DO OESTE;SC;80;32;112;285.714.285.714.285.000;714.285.714.285.714.000
4269;RIO RUFINO;SC;65;26;91;285.714.285.714.285.000;714.285.714.285.714.000
4368;SANCLERL∂NDIA;GO;110;44;154;285.714.285.714.285.000;714.285.714.285.714.000
4489;SANTA RITA DO NOVO DESTINO;GO;120;48;168;285.714.285.714.285.000;714.285.714.285.714.000
4465;SANTA MARIA DE ITABIRA;MG;160;64;224;285.714.285.714.285.000;714.285.714.285.714.000
4482;SANTA RITA DE CALDAS;MG;70;28;98;285.714.285.714.285.000;714.285.714.285.714.000
4494;SANTA RITA DO TRIVELATO;MT;80;32;112;285.714.285.714.285.000;714.285.714.285.714.000
3848;PIQUEROBI;SP;80;32;112;285.714.285.714.285.000;714.285.714.285.714.000
3601;PARA÷SO DO NORTE;PR;105;42;147;285.714.285.714.285.000;714.285.714.285.714.000
5055;SERRARIA;PB;70;28;98;285.714.285.714.285.000;714.285.714.285.714.000
5051;SERRAN‡POLIS;GO;90;36;126;285.714.285.714.285.000;714.285.714.285.714.000
4889;S«O PEDRO;RN;80;32;112;285.714.285.714.285.000;714.285.714.285.714.000
4647;S«O DOMINGOS DAS DORES;MG;90;36;126;285.714.285.714.285.000;714.285.714.285.714.000
4805;S«O JOSê DO GOIABAL;MG;135;54;189;285.714.285.714.285.000;714.285.714.285.714.000
4857;S«O MARTINHO DA SERRA;RS;85;34;119;285.714.285.714.285.000;714.285.714.285.714.000
4821;S«O JOSê DO SERID‡;RN;55;22;77;285.714.285.714.285.000;714.285.714.285.714.000
4830;S«O JOSê DOS QUATRO MARCOS;MT;150;60;210;285.714.285.714.285.000;714.285.714.285.714.000
4845;S«O LUIS DO PIAU÷;PI;55;22;77;285.714.285.714.285.000;714.285.714.285.714.000
5469;VARGEM BONITA;MG;70;28;98;285.714.285.714.285.000;714.285.714.285.714.000
5497;VENHA-VER;RN;60;24;84;285.714.285.714.285.000;714.285.714.285.714.000
5514;VERMELHO NOVO;MG;145;58;203;285.714.285.714.285.000;714.285.714.285.714.000
5565;VISTA GAÈCHA;RS;55;22;77;285.714.285.714.285.000;714.285.714.285.714.000
5225;TEIXEIRA SOARES;PR;150;60;210;285.714.285.714.285.000;714.285.714.285.714.000
5284;TOCANTIN‡POLIS;TO;135;54;189;285.714.285.714.285.000;714.285.714.285.714.000
4451;SANTA LUZIA;MG;798;319;1117;285.586.392.121.754.000;714.413.607.878.245.000
3350;NOVA IGUAÄU;RJ;1301;520;1821;285.557.386.051.619.000;714.442.613.948.380.000
3924;POÄOS DE CALDAS;MG;508;203;711;285.513.361.462.728.000;714.486.638.537.271.000
3646;PARNAMIRIM;RN;468;187;655;285.496.183.206.106.000;714.503.816.793.893.000
4772;S«O JOSê;SC;448;179;627;285.486.443.381.180.000;714.513.556.618.819.000
831;CABEDELO;PB;378;151;529;285.444.234.404.536.000;714.555.765.595.463.000
4734;S«O JO«O DE MERITI;RJ;994;397;1391;285.406.182.602.444.000;714.593.817.397.555.000
3995;PORTO NACIONAL;TO;318;127;445;285.393.258.426.966.000;714.606.741.573.033.000
2287;IREC“;BA;298;119;417;285.371.702.637.889.000;714.628.297.362.110.000
820;BURITIZEIRO;MG;298;119;417;285.371.702.637.889.000;714.628.297.362.110.000
2463;ITURAMA;MG;283;113;396;285.353.535.353.535.000;714.646.464.646.464.000
2594;JI-PARANµ;RO;451;180;631;285.261.489.698.890.000;714.738.510.301.109.000
5303;TRACUATEUA;PA;223;89;312;285.256.410.256.410.000;714.743.589.743.589.000
5037;SERRA DO RAMALHO;BA;208;83;291;285.223.367.697.594.000;714.776.632.302.405.000
5557;VIRGIN‡POLIS;MG;203;81;284;285.211.267.605.633.000;714.788.732.394.366.000
3886;PIRIPIRI;PI;198;79;277;285.198.555.956.678.000;714.801.444.043.321.000
3597;PARAIPABA;CE;193;77;270;285.185.185.185.185.000;714.814.814.814.814.000
960;CAMPINORTE;GO;188;75;263;285.171.102.661.596.000;714.828.897.338.403.000
2006;GUAPIARA;SP;188;75;263;285.171.102.661.596.000;714.828.897.338.403.000
5063;SERT∂NIA;PE;188;75;263;285.171.102.661.596.000;714.828.897.338.403.000
1177;CASSIL∂NDIA;MS;183;73;256;285.156.250.000.000.000;714.843.750.000.000.000
1058;CAP«O BONITO;SP;356;142;498;285.140.562.248.995.000;714.859.437.751.004.000
2428;ITATIAIUÄU;MG;178;71;249;285.140.562.248.995.000;714.859.437.751.004.000
4268;RIO REAL;BA;173;69;242;285.123.966.942.148.000;714.876.033.057.851.000
5306;TRAIR«O;PA;173;69;242;285.123.966.942.148.000;714.876.033.057.851.000
3800;PIEDADE;SP;341;136;477;285.115.303.983.228.000;714.884.696.016.771.000
1500;CUIABµ;MT;1013;404;1417;285.109.386.026.817.000;714.890.613.973.182.000
2545;JAQUEIRA;PE;168;67;235;285.106.382.978.723.000;714.893.617.021.276.000
3105;MIRANDA DO NORTE;MA;168;67;235;285.106.382.978.723.000;714.893.617.021.276.000
3923;POCONê;MT;163;65;228;285.087.719.298.245.000;714.912.280.701.754.000
4782;S«O JOSê DA VARGINHA;MG;158;63;221;285.067.873.303.167.000;714.932.126.696.832.000
1200;CATU;BA;311;124;435;285.057.471.264.367.000;714.942.528.735.632.000
1350;CONCEIÄ«O DO PARµ;MG;153;61;214;285.046.728.971.962.000;714.953.271.028.037.000
2165;IGREJA NOVA;AL;153;61;214;285.046.728.971.962.000;714.953.271.028.037.000
2035;GUARAQUEÄABA;PR;148;59;207;285.024.154.589.371.000;714.975.845.410.628.000
5552;VILHENA;RO;296;118;414;285.024.154.589.371.000;714.975.845.410.628.000
4220;RIO BRANCO DO SUL;PR;143;57;200;285.000.000.000.000.000;715.000.000.000.000.000
3681;PAU D'ARCO DO PIAU÷;PI;138;55;193;284.974.093.264.248.000;715.025.906.735.751.000
2285;IRATI;PR;271;108;379;284.960.422.163.588.000;715.039.577.836.411.000
545;BARREIRAS;BA;537;214;751;284.953.395.472.703.000;715.046.604.527.296.000
1901;GARUVA;SC;133;53;186;284.946.236.559.139.000;715.053.763.440.860.000
5223;TEIXEIRA;PB;133;53;186;284.946.236.559.139.000;715.053.763.440.860.000
4668;S«O FIDêLIS;RJ;266;106;372;284.946.236.559.139.000;715.053.763.440.860.000
5087;SILVIAN‡POLIS;MG;128;51;179;284.916.201.117.318.000;715.083.798.882.681.000
3931;POMPêIA;SP;251;100;351;284.900.284.900.284.000;715.099.715.099.715.000
3493;OURIÄANGAS;BA;123;49;172;284.883.720.930.232.000;715.116.279.069.767.000
3349;NOVA IBIµ;BA;123;49;172;284.883.720.930.232.000;715.116.279.069.767.000
703;BOM REPOUSO;MG;123;49;172;284.883.720.930.232.000;715.116.279.069.767.000
4568;SANTO ANT‚NIO;RN;123;49;172;284.883.720.930.232.000;715.116.279.069.767.000
5357;TUPANATINGA;PE;123;49;172;284.883.720.930.232.000;715.116.279.069.767.000
962;CAMPO ALEGRE;SC;118;47;165;284.848.484.848.484.000;715.151.515.151.515.000
1947;GONÄALVES;MG;118;47;165;284.848.484.848.484.000;715.151.515.151.515.000
5574;VIT‡RIA DO MEARIM;MA;236;94;330;284.848.484.848.484.000;715.151.515.151.515.000
1589;DIVIS‡POLIS;MG;113;45;158;284.810.126.582.278.000;715.189.873.417.721.000
1102;CARANDA÷;MG;226;90;316;284.810.126.582.278.000;715.189.873.417.721.000
3135;MOMBAÄA;CE;113;45;158;284.810.126.582.278.000;715.189.873.417.721.000
3770;PEREIRAS;SP;113;45;158;284.810.126.582.278.000;715.189.873.417.721.000
3596;PARAIBUNA;SP;221;88;309;284.789.644.012.944.000;715.210.355.987.055.000
3694;PAULISTAS;MG;108;43;151;284.768.211.920.529.000;715.231.788.079.470.000
3041;MATUPµ;MT;108;43;151;284.768.211.920.529.000;715.231.788.079.470.000
2847;MACAPARANA;PE;108;43;151;284.768.211.920.529.000;715.231.788.079.470.000
1476;CRIXµS;GO;216;86;302;284.768.211.920.529.000;715.231.788.079.470.000
1228;CENTRAL DE MINAS;MG;108;43;151;284.768.211.920.529.000;715.231.788.079.470.000
2904;MANDIRITUBA;PR;211;84;295;284.745.762.711.864.000;715.254.237.288.135.000
1957;GOVERNADOR EUG“NIO BARROS;MA;103;41;144;284.722.222.222.222.000;715.277.777.777.777.000
5513;VER÷SSIMO;MG;103;41;144;284.722.222.222.222.000;715.277.777.777.777.000
4613;S«O BENEDITO;CE;103;41;144;284.722.222.222.222.000;715.277.777.777.777.000
2049;GUARULHOS;SP;2314;921;3235;284.698.608.964.451.000;715.301.391.035.548.000
2620;JOINVILLE;SC;794;316;1110;284.684.684.684.684.000;715.315.315.315.315.000
3856;PIRA÷;RJ;289;115;404;284.653.465.346.534.000;715.346.534.653.465.000
3726;PEDR«O;BA;191;76;267;284.644.194.756.554.000;715.355.805.243.445.000
3962;PORECATU;PR;191;76;267;284.644.194.756.554.000;715.355.805.243.445.000
2658;JUPI;PE;93;37;130;284.615.384.615.384.000;715.384.615.384.615.000
2828;LUIZIANA;PR;93;37;130;284.615.384.615.384.000;715.384.615.384.615.000
83;AIQUARA;BA;93;37;130;284.615.384.615.384.000;715.384.615.384.615.000
1553;DESCALVADO;SP;274;109;383;284.595.300.261.096.000;715.404.699.738.903.000
3861;PIRAJU÷;SP;274;109;383;284.595.300.261.096.000;715.404.699.738.903.000
2613;JOAQUIM GOMES;AL;181;72;253;284.584.980.237.154.000;715.415.019.762.845.000
2226;INIMUTABA;MG;181;72;253;284.584.980.237.154.000;715.415.019.762.845.000
1761;FAXINAL;PR;88;35;123;284.552.845.528.455.000;715.447.154.471.544.000
1762;FAXINAL DO SOTURNO;RS;88;35;123;284.552.845.528.455.000;715.447.154.471.544.000
774;BREJO ALEGRE;SP;88;35;123;284.552.845.528.455.000;715.447.154.471.544.000
2686;LAFAIETE COUTINHO;BA;88;35;123;284.552.845.528.455.000;715.447.154.471.544.000
1159;CARUARU;PE;669;266;935;284.491.978.609.625.000;715.508.021.390.374.000
1086;CAPIT‡LIO;MG;83;33;116;284.482.758.620.689.000;715.517.241.379.310.000
2434;ITATUBA;PB;83;33;116;284.482.758.620.689.000;715.517.241.379.310.000
3139;MONDA÷;SC;83;33;116;284.482.758.620.689.000;715.517.241.379.310.000
4450;SANTA LUZIA;BA;166;66;232;284.482.758.620.689.000;715.517.241.379.310.000
4697;S«O GERALDO DO BAIXIO;MG;83;33;116;284.482.758.620.689.000;715.517.241.379.310.000
5327;TR“S RANCHOS;GO;83;33;116;284.482.758.620.689.000;715.517.241.379.310.000
437;AURORA DO PARµ;PA;239;95;334;284.431.137.724.550.000;715.568.862.275.449.000
2979;MAR÷LIA;SP;556;221;777;284.427.284.427.284.000;715.572.715.572.715.000
3464;OLINDA;PE;868;345;1213;284.418.796.372.629.000;715.581.203.627.370.000
3132;MOITA BONITA;SE;78;31;109;284.403.669.724.770.000;715.596.330.275.229.000
3120;MISSAL;PR;78;31;109;284.403.669.724.770.000;715.596.330.275.229.000
3346;NOVA GUARITA;MT;78;31;109;284.403.669.724.770.000;715.596.330.275.229.000
5361;TUPARENDI;RS;78;31;109;284.403.669.724.770.000;715.596.330.275.229.000
4941;S«O TIAGO;MG;156;62;218;284.403.669.724.770.000;715.596.330.275.229.000
4996;SENADOR ALEXANDRE COSTA;MA;78;31;109;284.403.669.724.770.000;715.596.330.275.229.000
1886;GµLIA;SP;151;60;211;284.360.189.573.459.000;715.639.810.426.540.000
1556;DESTERRO;PB;73;29;102;284.313.725.490.196.000;715.686.274.509.803.000
4742;S«O JO«O DO ITAPERIÈ;SC;73;29;102;284.313.725.490.196.000;715.686.274.509.803.000
674;BOM JARDIM;MA;214;85;299;284.280.936.454.849.000;715.719.063.545.150.000
3815;PIMENTA BUENO;RO;214;85;299;284.280.936.454.849.000;715.719.063.545.150.000
3049;MAURITI;CE;141;56;197;284.263.959.390.862.000;715.736.040.609.137.000
5492;VARZEL∂NDIA;MG;141;56;197;284.263.959.390.862.000;715.736.040.609.137.000
2907;MANGA;MG;209;83;292;284.246.575.342.465.000;715.753.424.657.534.000
2704;LAGOA DE S«O FRANCISCO;PI;68;27;95;284.210.526.315.789.000;715.789.473.684.210.000
3864;PIRANGI;SP;136;54;190;284.210.526.315.789.000;715.789.473.684.210.000
3599;PARA÷SO;SP;68;27;95;284.210.526.315.789.000;715.789.473.684.210.000
519;BARRA DE S«O MIGUEL;PB;68;27;95;284.210.526.315.789.000;715.789.473.684.210.000
4858;S«O MATEUS;ES;340;135;475;284.210.526.315.789.000;715.789.473.684.210.000
5355;TUP«;SP;335;133;468;284.188.034.188.034.000;715.811.965.811.965.000
4469;SANTA MARIA DO OESTE;PR;131;52;183;284.153.005.464.480.000;715.846.994.535.519.000
1040;CANINDê;CE;388;154;542;284.132.841.328.413.000;715.867.158.671.586.000
5385;UBAITABA;BA;194;77;271;284.132.841.328.413.000;715.867.158.671.586.000
2046;GUARINOS;GO;63;25;88;284.090.909.090.909.000;715.909.090.909.090.000
4226;RIO DA CONCEIÄ«O;TO;63;25;88;284.090.909.090.909.000;715.909.090.909.090.000
4863;S«O MIGUEL DA BAIXA GRANDE;PI;63;25;88;284.090.909.090.909.000;715.909.090.909.090.000
2371;ITAPACI;GO;184;73;257;284.046.692.607.003.000;715.953.307.392.996.000
2215;INGµ;PB;184;73;257;284.046.692.607.003.000;715.953.307.392.996.000
5405;UMBURANAS;BA;121;48;169;284.023.668.639.053.000;715.976.331.360.946.000
3935;PONTA GROSSA;PR;900;357;1257;284.009.546.539.379.000;715.990.453.460.620.000
4158;RESPLENDOR;MG;237;94;331;283.987.915.407.854.000;716.012.084.592.145.000
4311;ROSµRIO DO SUL;RS;237;94;331;283.987.915.407.854.000;716.012.084.592.145.000
4547;SANTANA DO PIAU÷;PI;58;23;81;283.950.617.283.950.000;716.049.382.716.049.000
3841;PINHEIRO PRETO;SC;58;23;81;283.950.617.283.950.000;716.049.382.716.049.000
3604;PARAIS‡POLIS;MG;232;92;324;283.950.617.283.950.000;716.049.382.716.049.000
2558;JARDIM OLINDA;PR;58;23;81;283.950.617.283.950.000;716.049.382.716.049.000
3370;NOVA OL÷MPIA;MT;174;69;243;283.950.617.283.950.000;716.049.382.716.049.000
5386;UBAJARA;CE;116;46;162;283.950.617.283.950.000;716.049.382.716.049.000
1838;FORMOSO DO ARAGUAIA;TO;227;90;317;283.911.671.924.290.000;716.088.328.075.709.000
2125;IBIRAPITANGA;BA;169;67;236;283.898.305.084.745.000;716.101.694.915.254.000
5016;SENHORA DOS REMêDIOS;MG;169;67;236;283.898.305.084.745.000;716.101.694.915.254.000
1927;GL‡RIA D'OESTE;MT;111;44;155;283.870.967.741.935.000;716.129.032.258.064.000
1080;CAPIT«O ANDRADE;MG;111;44;155;283.870.967.741.935.000;716.129.032.258.064.000
2698;LAGOA DA CONFUS«O;TO;111;44;155;283.870.967.741.935.000;716.129.032.258.064.000
4056;PRESIDENTE OLEGµRIO;MG;164;65;229;283.842.794.759.825.000;716.157.205.240.174.000
2118;IBIRµ;SP;164;65;229;283.842.794.759.825.000;716.157.205.240.174.000
1645;DUMONT;SP;164;65;229;283.842.794.759.825.000;716.157.205.240.174.000
1852;FRAIBURGO;SC;217;86;303;283.828.382.838.283.000;716.171.617.161.716.000
3495;OURIL∂NDIA DO NORTE;PA;217;86;303;283.828.382.838.283.000;716.171.617.161.716.000
502;BARBALHA;CE;270;107;377;283.819.628.647.214.000;716.180.371.352.785.000
181;ALVORADA DE MINAS;MG;159;63;222;283.783.783.783.783.000;716.216.216.216.216.000
1204;CATURA÷;GO;106;42;148;283.783.783.783.783.000;716.216.216.216.216.000
3691;PAULISTA;PB;53;21;74;283.783.783.783.783.000;716.216.216.216.216.000
2790;LIMOEIRO;PE;212;84;296;283.783.783.783.783.000;716.216.216.216.216.000
5471;VARGEM GRANDE;MA;207;82;289;283.737.024.221.453.000;716.262.975.778.546.000
3659;PASSIRA;PE;154;61;215;283.720.930.232.558.000;716.279.069.767.441.000
1583;DIVINOL∂NDIA DE MINAS;MG;202;80;282;283.687.943.262.411.000;716.312.056.737.588.000
2058;GUIRICEMA;MG;101;40;141;283.687.943.262.411.000;716.312.056.737.588.000
232;ANDRADAS;MG;202;80;282;283.687.943.262.411.000;716.312.056.737.588.000
989;CAMPO NOVO;RS;101;40;141;283.687.943.262.411.000;716.312.056.737.588.000
5030;SERRA BRANCA;PB;101;40;141;283.687.943.262.411.000;716.312.056.737.588.000
3580;P«O DE AÄÈCAR;AL;149;59;208;283.653.846.153.846.000;716.346.153.846.153.000
2366;ITANHOMI;MG;197;78;275;283.636.363.636.363.000;716.363.636.363.636.000
1217;CEDRAL;MA;197;78;275;283.636.363.636.363.000;716.363.636.363.636.000
1611;DOM PEDRO;MA;96;38;134;283.582.089.552.238.000;716.417.910.447.761.000
2090;IAPU;MG;96;38;134;283.582.089.552.238.000;716.417.910.447.761.000
3572;PALM‡POLIS;MG;96;38;134;283.582.089.552.238.000;716.417.910.447.761.000
5022;SERINGUEIRAS;RO;192;76;268;283.582.089.552.238.000;716.417.910.447.761.000
4822;S«O JOSê DO SUL;RS;48;19;67;283.582.089.552.238.000;716.417.910.447.761.000
1185;CASTRO;PR;326;129;455;283.516.483.516.483.000;716.483.516.483.516.000
4567;SANTO ∂NGELO;RS;230;91;321;283.489.096.573.208.000;716.510.903.426.791.000
4676;S«O FRANCISCO DE ITABAPOANA;RJ;321;127;448;283.482.142.857.142.000;716.517.857.142.857.000
4099;QUELUZ;SP;182;72;254;283.464.566.929.133.000;716.535.433.070.866.000
4117;QUIXADµ;CE;273;108;381;283.464.566.929.133.000;716.535.433.070.866.000
2557;JARDIM DO SERID‡;RN;91;36;127;283.464.566.929.133.000;716.535.433.070.866.000
2514;JAGUARIBE;CE;182;72;254;283.464.566.929.133.000;716.535.433.070.866.000
1490;CRUZEIRO DO IGUAÄU;PR;91;36;127;283.464.566.929.133.000;716.535.433.070.866.000
1146;CARNA÷BA;PE;91;36;127;283.464.566.929.133.000;716.535.433.070.866.000
4640;S«O CRIST‡V«O;SE;493;195;688;283.430.232.558.139.000;716.569.767.441.860.000
587;BELêM DE MARIA;PE;134;53;187;283.422.459.893.048.000;716.577.540.106.951.000
1289;CLARO DOS POÄÂES;MG;134;53;187;283.422.459.893.048.000;716.577.540.106.951.000
1393;CORDISBURGO;MG;134;53;187;283.422.459.893.048.000;716.577.540.106.951.000
4390;SANTA CEC÷LIA;SC;177;70;247;283.400.809.716.599.000;716.599.190.283.400.000
3538;PALESTINA;SP;177;70;247;283.400.809.716.599.000;716.599.190.283.400.000
5145;TABATINGA;SP;177;70;247;283.400.809.716.599.000;716.599.190.283.400.000
2176;IJACI;MG;220;87;307;283.387.622.149.837.000;716.612.377.850.162.000
4097;QUEIMADOS;RJ;521;206;727;283.356.258.596.973.000;716.643.741.403.026.000
3382;NOVA PORTEIRINHA;MG;129;51;180;283.333.333.333.333.000;716.666.666.666.666.000
1604;DOM ELISEU;PA;258;102;360;283.333.333.333.333.000;716.666.666.666.666.000
782;BREJO SANTO;CE;86;34;120;283.333.333.333.333.000;716.666.666.666.666.000
72;µGUAS FRIAS;SC;43;17;60;283.333.333.333.333.000;716.666.666.666.666.000
5171;TAMBORIL;CE;86;34;120;283.333.333.333.333.000;716.666.666.666.666.000
109;ALENQUER;PA;377;149;526;283.269.961.977.186.000;716.730.038.022.813.000
1430;CORRENTINA;BA;167;66;233;283.261.802.575.107.000;716.738.197.424.892.000
3502;OURO FINO;MG;291;115;406;283.251.231.527.093.000;716.748.768.472.906.000
1519;CURIÈVA;PR;124;49;173;283.236.994.219.653.000;716.763.005.780.346.000
2221;INHAPI;AL;124;49;173;283.236.994.219.653.000;716.763.005.780.346.000
1978;GR«O-PARµ;SC;81;32;113;283.185.840.707.964.000;716.814.159.292.035.000
4500;SANTA ROSA DE LIMA;SE;81;32;113;283.185.840.707.964.000;716.814.159.292.035.000
2320;ITAGUAÄU;ES;162;64;226;283.185.840.707.964.000;716.814.159.292.035.000
2630;JOSEN‡POLIS;MG;81;32;113;283.185.840.707.964.000;716.814.159.292.035.000
5393;UBIRAJARA;SP;162;64;226;283.185.840.707.964.000;716.814.159.292.035.000
4312;ROSµRIO OESTE;MT;157;62;219;283.105.022.831.050.000;716.894.977.168.949.000
3729;PEDRAS DE MARIA DA CRUZ;MG;195;77;272;283.088.235.294.117.000;716.911.764.705.882.000
170;ALTOS;PI;195;77;272;283.088.235.294.117.000;716.911.764.705.882.000
1885;GADO BRAVO;PB;114;45;159;283.018.867.924.528.000;716.981.132.075.471.000
2117;IBIQUERA;BA;76;30;106;283.018.867.924.528.000;716.981.132.075.471.000
2069;HERCUL∂NDIA;SP;114;45;159;283.018.867.924.528.000;716.981.132.075.471.000
2065;HARMONIA;RS;76;30;106;283.018.867.924.528.000;716.981.132.075.471.000
1245;CESµRIO LANGE;SP;190;75;265;283.018.867.924.528.000;716.981.132.075.471.000
3758;PENµPOLIS;SP;342;135;477;283.018.867.924.528.000;716.981.132.075.471.000
3189;MORADA NOVA;CE;190;75;265;283.018.867.924.528.000;716.981.132.075.471.000
3650;PASSA QUATRO;MG;147;58;205;282.926.829.268.292.000;717.073.170.731.707.000
141;ALTIN‡POLIS;SP;256;101;357;282.913.165.266.106.000;717.086.834.733.893.000
68;µGUAS DE LIND‡IA;SP;218;86;304;282.894.736.842.105.000;717.105.263.157.894.000
580;BELA VISTA DO PARA÷SO;PR;218;86;304;282.894.736.842.105.000;717.105.263.157.894.000
2101;IBIµ;MG;218;86;304;282.894.736.842.105.000;717.105.263.157.894.000
2807;LONDRINA;PR;867;342;1209;282.878.411.910.669.000;717.121.588.089.330.000
2702;LAGOA DE ITAENGA;PE;180;71;251;282.868.525.896.414.000;717.131.474.103.585.000
3263;NATIVIDADE DA SERRA;SP;180;71;251;282.868.525.896.414.000;717.131.474.103.585.000
4939;S«O SIM«O;SP;180;71;251;282.868.525.896.414.000;717.131.474.103.585.000
596;BELO HORIZONTE;MG;2774;1094;3868;282.833.505.687.693.000;717.166.494.312.306.000
142;ALTO ALEGRE;RR;142;56;198;282.828.282.828.282.000;717.171.717.171.717.000
259;ANTONINA DO NORTE;CE;71;28;99;282.828.282.828.282.000;717.171.717.171.717.000
1819;FLORESTAL;MG;142;56;198;282.828.282.828.282.000;717.171.717.171.717.000
1433;CORUMBµ DE GOIµS;GO;142;56;198;282.828.282.828.282.000;717.171.717.171.717.000
2555;JARDIM DE PIRANHAS;RN;71;28;99;282.828.282.828.282.000;717.171.717.171.717.000
2548;JARAGUµ DO SUL;SC;317;125;442;282.805.429.864.253.000;717.194.570.135.746.000
3557;PALMEIRA DOS ÷NDIOS;AL;317;125;442;282.805.429.864.253.000;717.194.570.135.746.000
1772;FEIRA NOVA;PE;175;69;244;282.786.885.245.901.000;717.213.114.754.098.000
843;CACEQUI;RS;104;41;145;282.758.620.689.655.000;717.241.379.310.344.000
4064;PRIMAVERA DE ROND‚NIA;RO;104;41;145;282.758.620.689.655.000;717.241.379.310.344.000
5097;SIQUEIRA CAMPOS;PR;208;82;290;282.758.620.689.655.000;717.241.379.310.344.000
2672;JUSCIMEIRA;MT;170;67;237;282.700.421.940.928.000;717.299.578.059.071.000
3094;MIRABELA;MG;170;67;237;282.700.421.940.928.000;717.299.578.059.071.000
1024;CANDELµRIA;RS;170;67;237;282.700.421.940.928.000;717.299.578.059.071.000
484;BANDEIRA DO SUL;MG;170;67;237;282.700.421.940.928.000;717.299.578.059.071.000
1382;COQUEIRAL;MG;170;67;237;282.700.421.940.928.000;717.299.578.059.071.000
2290;IRITUIA;PA;203;80;283;282.685.512.367.491.000;717.314.487.632.508.000
5299;TORRES;RS;236;93;329;282.674.772.036.474.000;717.325.227.963.525.000
2501;JACUPIRANGA;SP;231;91;322;282.608.695.652.173.000;717.391.304.347.826.000
2498;JACU÷PE;AL;132;52;184;282.608.695.652.173.000;717.391.304.347.826.000
3239;MUQUêM DO S«O FRANCISCO;BA;99;39;138;282.608.695.652.173.000;717.391.304.347.826.000
4282;ROCHEDO DE MINAS;MG;132;52;184;282.608.695.652.173.000;717.391.304.347.826.000
5543;VILA MARIA;RS;66;26;92;282.608.695.652.173.000;717.391.304.347.826.000
5135;SUMê;PB;132;52;184;282.608.695.652.173.000;717.391.304.347.826.000
4925;S«O SEBASTI«O DO ALTO;RJ;99;39;138;282.608.695.652.173.000;717.391.304.347.826.000
1029;C∂NDIDO MOTA;SP;193;76;269;282.527.881.040.892.000;717.472.118.959.107.000
2088;IACRI;SP;160;63;223;282.511.210.762.331.000;717.488.789.237.668.000
939;CAMOCIM;CE;287;113;400;282.500.000.000.000.000;717.500.000.000.000.000
1124;CARIRA;SE;127;50;177;282.485.875.706.214.000;717.514.124.293.785.000
3409;NOVA XAVANTINA;MT;127;50;177;282.485.875.706.214.000;717.514.124.293.785.000
5561;VISEU;PA;254;100;354;282.485.875.706.214.000;717.514.124.293.785.000
3777;PEROBAL;PR;94;37;131;282.442.748.091.603.000;717.557.251.908.396.000
628;BIGUAÄU;SC;282;111;393;282.442.748.091.603.000;717.557.251.908.396.000
134;ALTAIR;SP;94;37;131;282.442.748.091.603.000;717.557.251.908.396.000
1481;CRUZ;CE;94;37;131;282.442.748.091.603.000;717.557.251.908.396.000
5018;SENTO Sê;BA;188;74;262;282.442.748.091.603.000;717.557.251.908.396.000
48;µGUA BRANCA;AL;155;61;216;282.407.407.407.407.000;717.592.592.592.592.000
4264;RIO POMBA;MG;155;61;216;282.407.407.407.407.000;717.592.592.592.592.000
2519;JA÷BA;MG;277;109;386;282.383.419.689.119.000;717.616.580.310.880.000
64;AGUANIL;MG;122;48;170;282.352.941.176.470.000;717.647.058.823.529.000
318;ARAGUAINHA;MT;61;24;85;282.352.941.176.470.000;717.647.058.823.529.000
1606;DOM FELICIANO;RS;122;48;170;282.352.941.176.470.000;717.647.058.823.529.000
1619;DONA FRANCISCA;RS;61;24;85;282.352.941.176.470.000;717.647.058.823.529.000
5566;VISTA SERRANA;PB;61;24;85;282.352.941.176.470.000;717.647.058.823.529.000
2983;MµRIO CAMPOS;MG;272;107;379;282.321.899.736.147.000;717.678.100.263.852.000
3683;PAUDALHO;PE;361;142;503;282.306.163.021.868.000;717.693.836.978.131.000
905;CAJUEIRO;AL;150;59;209;282.296.650.717.703.000;717.703.349.282.296.000
3542;PALHOÄA;SC;389;153;542;282.287.822.878.228.000;717.712.177.121.771.000
5468;VARGEM ALTA;ES;239;94;333;282.282.282.282.282.000;717.717.717.717.717.000
2935;MARAGOGI;AL;178;70;248;282.258.064.516.129.000;717.741.935.483.870.000
2870;MAFRA;SC;267;105;372;282.258.064.516.129.000;717.741.935.483.870.000
2636;JUAZEIRINHO;PB;178;70;248;282.258.064.516.129.000;717.741.935.483.870.000
150;ALTO BOA VISTA;MT;89;35;124;282.258.064.516.129.000;717.741.935.483.870.000
1412;CORONEL JO«O Sµ;BA;89;35;124;282.258.064.516.129.000;717.741.935.483.870.000
1250;CH« PRETA;AL;89;35;124;282.258.064.516.129.000;717.741.935.483.870.000
1899;GARRAF«O DO NORTE;PA;178;70;248;282.258.064.516.129.000;717.741.935.483.870.000
5094;SIMPL÷CIO MENDES;PI;89;35;124;282.258.064.516.129.000;717.741.935.483.870.000
5116;SOLEDADE DE MINAS;MG;178;70;248;282.258.064.516.129.000;717.741.935.483.870.000
2468;IVA÷;PR;117;46;163;282.208.588.957.055.000;717.791.411.042.944.000
4321;RUSSAS;CE;262;103;365;282.191.780.821.917.000;717.808.219.178.082.000
2110;IBICOARA;BA;145;57;202;282.178.217.821.782.000;717.821.782.178.217.000
2896;MANACAPURU;AM;463;182;645;282.170.542.635.658.000;717.829.457.364.341.000
2977;MARIL∂NDIA DO SUL;PR;140;55;195;282.051.282.051.282.000;717.948.717.948.717.000
3010;MATA ROMA;MA;84;33;117;282.051.282.051.282.000;717.948.717.948.717.000
3351;NOVA IGUAÄU DE GOIµS;GO;84;33;117;282.051.282.051.282.000;717.948.717.948.717.000
3143;MONSENHOR HIP‡LITO;PI;56;22;78;282.051.282.051.282.000;717.948.717.948.717.000
2647;JÈLIO DE CASTILHOS;RS;140;55;195;282.051.282.051.282.000;717.948.717.948.717.000
2714;LAGOA DOS PATOS;MG;112;44;156;282.051.282.051.282.000;717.948.717.948.717.000
4335;SALES OLIVEIRA;SP;112;44;156;282.051.282.051.282.000;717.948.717.948.717.000
4218;RIO BRANCO;MT;84;33;117;282.051.282.051.282.000;717.948.717.948.717.000
4049;PRESIDENTE KENNEDY;TO;84;33;117;282.051.282.051.282.000;717.948.717.948.717.000
3534;PAINS;MG;140;55;195;282.051.282.051.282.000;717.948.717.948.717.000
3632;PARAZINHO;RN;84;33;117;282.051.282.051.282.000;717.948.717.948.717.000
3727;PEDRAS ALTAS;RS;84;33;117;282.051.282.051.282.000;717.948.717.948.717.000
2194;IMBITUVA;PR;196;77;273;282.051.282.051.282.000;717.948.717.948.717.000
1860;FRANCISCO DUMONT;MG;140;55;195;282.051.282.051.282.000;717.948.717.948.717.000
1966;GRAÄA;CE;84;33;117;282.051.282.051.282.000;717.948.717.948.717.000
1758;FµTIMA;BA;84;33;117;282.051.282.051.282.000;717.948.717.948.717.000
1242;CERRO GRANDE DO SUL;RS;140;55;195;282.051.282.051.282.000;717.948.717.948.717.000
162;ALTO PARANµ;PR;112;44;156;282.051.282.051.282.000;717.948.717.948.717.000
143;ALTO ALEGRE;RS;56;22;78;282.051.282.051.282.000;717.948.717.948.717.000
89;ALAGOA NOVA;PB;140;55;195;282.051.282.051.282.000;717.948.717.948.717.000
333;ARAPIRACA;AL;364;143;507;282.051.282.051.282.000;717.948.717.948.717.000
5180;TANQUE DO PIAU÷;PI;56;22;78;282.051.282.051.282.000;717.948.717.948.717.000
5437;URUÄU÷;PI;112;44;156;282.051.282.051.282.000;717.948.717.948.717.000
439;AUTAZES;AM;275;108;383;281.984.334.203.655.000;718.015.665.796.344.000
1070;CAPELINHA;MG;191;75;266;281.954.887.218.045.000;718.045.112.781.954.000
5594;XANGRI-Lµ;RS;163;64;227;281.938.325.991.189.000;718.061.674.008.810.000
897;CAJAMAR;SP;461;181;642;281.931.464.174.454.000;718.068.535.825.545.000
2202;INCONFIDENTES;MG;135;53;188;281.914.893.617.021.000;718.085.106.382.978.000
4244;RIO ESPERA;MG;135;53;188;281.914.893.617.021.000;718.085.106.382.978.000
4612;SANTOS DUMONT;MG;377;148;525;281.904.761.904.761.000;718.095.238.095.238.000
4401;SANTA CRUZ DA ESPERANÄA;SP;107;42;149;281.879.194.630.872.000;718.120.805.369.127.000
3511;OUROESTE;SP;107;42;149;281.879.194.630.872.000;718.120.805.369.127.000
1270;CHIADOR;MG;107;42;149;281.879.194.630.872.000;718.120.805.369.127.000
1104;CARAPEBUS;RJ;214;84;298;281.879.194.630.872.000;718.120.805.369.127.000
5255;TERRA ROXA;PR;107;42;149;281.879.194.630.872.000;718.120.805.369.127.000
3576;PANCAS;ES;265;104;369;281.842.818.428.184.000;718.157.181.571.815.000
2945;MARATA÷ZES;ES;344;135;479;281.837.160.751.565.000;718.162.839.248.434.000
3983;PORTO DO MANGUE;RN;79;31;110;281.818.181.818.181.000;718.181.818.181.818.000
4396;SANTA CRUZ;PE;79;31;110;281.818.181.818.181.000;718.181.818.181.818.000
685;BOM JESUS DA PENHA;MG;79;31;110;281.818.181.818.181.000;718.181.818.181.818.000
183;ALVORADA DO NORTE;GO;79;31;110;281.818.181.818.181.000;718.181.818.181.818.000
2114;IBIPEBA;BA;79;31;110;281.818.181.818.181.000;718.181.818.181.818.000
319;ARAGUAN«;MA;130;51;181;281.767.955.801.104.000;718.232.044.198.895.000
1261;CHAPAD«O DO SUL;MS;153;60;213;281.690.140.845.070.000;718.309.859.154.929.000
4483;SANTA RITA DE CµSSIA;BA;153;60;213;281.690.140.845.070.000;718.309.859.154.929.000
5109;SOBRAL;CE;431;169;600;281.666.666.666.666.000;718.333.333.333.333.000
1842;FORTALEZA;CE;2303;903;3206;281.659.388.646.288.000;718.340.611.353.711.000
2638;JUAZEIRO DO NORTE;CE;556;218;774;281.653.746.770.025.000;718.346.253.229.974.000
2421;ITARANTIM;BA;176;69;245;281.632.653.061.224.000;718.367.346.938.775.000
852;CACHOEIRA DO PIRIµ;PA;176;69;245;281.632.653.061.224.000;718.367.346.938.775.000
5387;UBAPORANGA;MG;176;69;245;281.632.653.061.224.000;718.367.346.938.775.000
5371;TURMALINA;MG;176;69;245;281.632.653.061.224.000;718.367.346.938.775.000
316;ARAGUAIANA;MT;125;49;174;281.609.195.402.298.000;718.390.804.597.701.000
5555;VIRGEM DA LAPA;MG;125;49;174;281.609.195.402.298.000;718.390.804.597.701.000
3391;NOVA RUSSAS;CE;199;78;277;281.588.447.653.429.000;718.411.552.346.570.000
3951;PONTES E LACERDA;MT;199;78;277;281.588.447.653.429.000;718.411.552.346.570.000
5502;VERA CRUZ;SP;199;78;277;281.588.447.653.429.000;718.411.552.346.570.000
2900;MANAUS;AM;2286;896;3182;281.583.909.490.886.000;718.416.090.509.113.000
2365;ITANHêM;BA;148;58;206;281.553.398.058.252.000;718.446.601.941.747.000
4532;SANTANA DE PIRAPAMA;MG;148;58;206;281.553.398.058.252.000;718.446.601.941.747.000
219;ANAM«;AM;148;58;206;281.553.398.058.252.000;718.446.601.941.747.000
252;AN÷SIO DE ABREU;PI;74;29;103;281.553.398.058.252.000;718.446.601.941.747.000
4984;SEARA;SC;74;29;103;281.553.398.058.252.000;718.446.601.941.747.000
2600;JOAN‡POLIS;SP;171;67;238;281.512.605.042.016.000;718.487.394.957.983.000
4912;S«O ROM«O;MG;171;67;238;281.512.605.042.016.000;718.487.394.957.983.000
5538;VILA BELA DA SANT÷SSIMA TRINDADE;MT;171;67;238;281.512.605.042.016.000;718.487.394.957.983.000
3798;PICOS;PI;268;105;373;281.501.340.482.573.000;718.498.659.517.426.000
3903;PLANALTO;SP;97;38;135;281.481.481.481.481.000;718.518.518.518.518.000
2451;ITOBI;SP;194;76;270;281.481.481.481.481.000;718.518.518.518.518.000
2227;INOC“NCIA;MS;97;38;135;281.481.481.481.481.000;718.518.518.518.518.000
4673;S«O FRANCISCO DE ASSIS;RS;97;38;135;281.481.481.481.481.000;718.518.518.518.518.000
2189;IMARU÷;SC;143;56;199;281.407.035.175.879.000;718.592.964.824.120.000
5300;TORRINHA;SP;143;56;199;281.407.035.175.879.000;718.592.964.824.120.000
1756;FARTURA;SP;166;65;231;281.385.281.385.281.000;718.614.718.614.718.000
2256;IPOR«;PR;115;45;160;281.250.000.000.000.000;718.750.000.000.000.000
2057;GUIRATINGA;MT;92;36;128;281.250.000.000.000.000;718.750.000.000.000.000
1394;CORDISL∂NDIA;MG;115;45;160;281.250.000.000.000.000;718.750.000.000.000.000
1710;ESPERANTIN‡POLIS;MA;115;45;160;281.250.000.000.000.000;718.750.000.000.000.000
477;BµLSAMO;SP;115;45;160;281.250.000.000.000.000;718.750.000.000.000.000
816;BURITIRANA;MA;115;45;160;281.250.000.000.000.000;718.750.000.000.000.000
3492;OURêM;PA;161;63;224;281.250.000.000.000.000;718.750.000.000.000.000
4564;SANTO ANASTµCIO;SP;253;99;352;281.250.000.000.000.000;718.750.000.000.000.000
4164;RIACH«O;PB;69;27;96;281.250.000.000.000.000;718.750.000.000.000.000
5209;TAQUARUSSU;MS;69;27;96;281.250.000.000.000.000;718.750.000.000.000.000
4752;S«O JO«O DO PAU D'ALHO;SP;69;27;96;281.250.000.000.000.000;718.750.000.000.000.000
5034;SERRA DE S«O BENTO;RN;69;27;96;281.250.000.000.000.000;718.750.000.000.000.000
2414;ITAPURANGA;GO;202;79;281;281.138.790.035.587.000;718.861.209.964.412.000
2168;IGUA÷;BA;156;61;217;281.105.990.783.410.000;718.894.009.216.589.000
547;BARREIRINHA;AM;266;104;370;281.081.081.081.081.000;718.918.918.918.918.000
3279;NEVES PAULISTA;SP;133;52;185;281.081.081.081.081.000;718.918.918.918.918.000
4441;SANTA ISABEL DO RIO NEGRO;AM;133;52;185;281.081.081.081.081.000;718.918.918.918.918.000
3788;PETROLINA DE GOIµS;GO;133;52;185;281.081.081.081.081.000;718.918.918.918.918.000
3836;PINH«O;SE;110;43;153;281.045.751.633.986.000;718.954.248.366.013.000
2968;MARIANA;MG;330;129;459;281.045.751.633.986.000;718.954.248.366.013.000
2377;ITAPECERICA;MG;220;86;306;281.045.751.633.986.000;718.954.248.366.013.000
731;BORACêIA;SP;110;43;153;281.045.751.633.986.000;718.954.248.366.013.000
1365;CONFINS;MG;220;86;306;281.045.751.633.986.000;718.954.248.366.013.000
4631;S«O BRµS;AL;110;43;153;281.045.751.633.986.000;718.954.248.366.013.000
5230;TEL“MACO BORBA;PR;394;154;548;281.021.897.810.218.000;718.978.102.189.781.000
1855;FRANCISCO ALVES;PR;87;34;121;280.991.735.537.190.000;719.008.264.462.809.000
331;ARANTINA;MG;87;34;121;280.991.735.537.190.000;719.008.264.462.809.000
5317;TR“S CORAÄÂES;MG;407;159;566;280.918.727.915.194.000;719.081.272.084.805.000
273;APARECIDA DE GOI∂NIA;GO;1047;409;1456;280.906.593.406.593.000;719.093.406.593.406.000
652;BOA VISTA DO CADEADO;RS;64;25;89;280.898.876.404.494.000;719.101.123.595.505.000
2144;ICATU;MA;192;75;267;280.898.876.404.494.000;719.101.123.595.505.000
1367;CONGO;PB;64;25;89;280.898.876.404.494.000;719.101.123.595.505.000
4592;SANTO ANT‚NIO DO PALMA;RS;64;25;89;280.898.876.404.494.000;719.101.123.595.505.000
5587;WENCESLAU BRAZ;PR;192;75;267;280.898.876.404.494.000;719.101.123.595.505.000
986;CAMPO MAGRO;PR;297;116;413;280.871.670.702.179.000;719.128.329.297.820.000
2609;JO«O PESSOA;PB;1096;428;1524;280.839.895.013.123.000;719.160.104.986.876.000
3952;PONTES GESTAL;SP;105;41;146;280.821.917.808.219.000;719.178.082.191.780.000
3707;PEÄANHA;MG;210;82;292;280.821.917.808.219.000;719.178.082.191.780.000
741;BOTUMIRIM;MG;105;41;146;280.821.917.808.219.000;719.178.082.191.780.000
321;ARAGUAPAZ;GO;146;57;203;280.788.177.339.901.000;719.211.822.660.098.000
1539;DµRIO MEIRA;BA;146;57;203;280.788.177.339.901.000;719.211.822.660.098.000
1841;FORQUILHINHA;SC;146;57;203;280.788.177.339.901.000;719.211.822.660.098.000
2668;JURUµ;AM;146;57;203;280.788.177.339.901.000;719.211.822.660.098.000
2577;JENIPAPO DE MINAS;MG;82;32;114;280.701.754.385.964.000;719.298.245.614.035.000
3068;MESQUITA;MG;164;64;228;280.701.754.385.964.000;719.298.245.614.035.000
4310;ROSµRIO DO IVA÷;PR;82;32;114;280.701.754.385.964.000;719.298.245.614.035.000
1866;FRANCO DA ROCHA;SP;451;176;627;280.701.754.385.964.000;719.298.245.614.035.000
1904;GAÈCHA DO NORTE;MT;82;32;114;280.701.754.385.964.000;719.298.245.614.035.000
2072;HERVEIRAS;RS;82;32;114;280.701.754.385.964.000;719.298.245.614.035.000
737;BORRAZ‡POLIS;PR;123;48;171;280.701.754.385.964.000;719.298.245.614.035.000
5039;SERRA DOS AIMORêS;MG;123;48;171;280.701.754.385.964.000;719.298.245.614.035.000
362;ARAXµ;MG;428;167;595;280.672.268.907.563.000;719.327.731.092.436.000
4427;SANTA HELENA;MA;223;87;310;280.645.161.290.322.000;719.354.838.709.677.000
3107;MIRAND‡POLIS;SP;182;71;253;280.632.411.067.193.000;719.367.588.932.806.000
1962;GOVERNADOR MANGABEIRA;BA;182;71;253;280.632.411.067.193.000;719.367.588.932.806.000
5598;XAXIM;SC;141;55;196;280.612.244.897.959.000;719.387.755.102.040.000
1651;EDEALINA;GO;100;39;139;280.575.539.568.345.000;719.424.460.431.654.000
1825;FL‡RIDA PAULISTA;SP;159;62;221;280.542.986.425.339.000;719.457.013.574.660.000
1974;GRANITO;PE;59;23;82;280.487.804.878.048.000;719.512.195.121.951.000
1869;FREI GASPAR;MG;118;46;164;280.487.804.878.048.000;719.512.195.121.951.000
1997;GUAJARµ;AM;118;46;164;280.487.804.878.048.000;719.512.195.121.951.000
2243;IPIAÈ;BA;236;92;328;280.487.804.878.048.000;719.512.195.121.951.000
1673;ENCRUZILHADA DO SUL;RS;177;69;246;280.487.804.878.048.000;719.512.195.121.951.000
1053;CANUDOS DO VALE;RS;59;23;82;280.487.804.878.048.000;719.512.195.121.951.000
3015;MATEL∂NDIA;PR;118;46;164;280.487.804.878.048.000;719.512.195.121.951.000
2659;JUPIµ;SC;59;23;82;280.487.804.878.048.000;719.512.195.121.951.000
3531;PAIM FILHO;RS;59;23;82;280.487.804.878.048.000;719.512.195.121.951.000
5212;TARRAFAS;CE;59;23;82;280.487.804.878.048.000;719.512.195.121.951.000
4651;S«O DOMINGOS DO CAPIM;PA;236;92;328;280.487.804.878.048.000;719.512.195.121.951.000
4864;S«O MIGUEL DA BOA VISTA;SC;59;23;82;280.487.804.878.048.000;719.512.195.121.951.000
1354;CONCHAL;SP;331;129;460;280.434.782.608.695.000;719.565.217.391.304.000
1233;CEREJEIRAS;RO;136;53;189;280.423.280.423.280.000;719.576.719.576.719.000
806;BURITI;MA;213;83;296;280.405.405.405.405.000;719.594.594.594.594.000
1668;EMBU-GUAÄU;SP;444;173;617;280.388.978.930.307.000;719.611.021.069.692.000
2257;IPOR« DO OESTE;SC;77;30;107;280.373.831.775.700.000;719.626.168.224.299.000
726;BOQUEIR«O DO LE«O;RS;77;30;107;280.373.831.775.700.000;719.626.168.224.299.000
1035;CANELINHA;SC;77;30;107;280.373.831.775.700.000;719.626.168.224.299.000
115;ALFREDO VASCONCELOS;MG;154;60;214;280.373.831.775.700.000;719.626.168.224.299.000
4598;SANTO ANT‚NIO DO SUDOESTE;PR;77;30;107;280.373.831.775.700.000;719.626.168.224.299.000
5204;TAQUARITINGA;SP;308;120;428;280.373.831.775.700.000;719.626.168.224.299.000
5315;TR“S BARRAS DO PARANµ;PR;77;30;107;280.373.831.775.700.000;719.626.168.224.299.000
5329;TREVISO;SC;77;30;107;280.373.831.775.700.000;719.626.168.224.299.000
5588;WENCESLAU GUIMAR«ES;BA;231;90;321;280.373.831.775.700.000;719.626.168.224.299.000
5548;VILA PROP÷CIO;GO;154;60;214;280.373.831.775.700.000;719.626.168.224.299.000
2301;ITABERABA;BA;249;97;346;280.346.820.809.248.000;719.653.179.190.751.000
5173;TANABI;SP;172;67;239;280.334.728.033.472.000;719.665.271.966.527.000
4709;S«O GOTARDO;MG;267;104;371;280.323.450.134.770.000;719.676.549.865.229.000
2546;JAQUIRANA;RS;95;37;132;280.303.030.303.030.000;719.696.969.696.969.000
4239;RIO DO SUL;SC;190;74;264;280.303.030.303.030.000;719.696.969.696.969.000
1342;CONCEIÄ«O DO ALMEIDA;BA;190;74;264;280.303.030.303.030.000;719.696.969.696.969.000
5540;VILA FLOR;RN;95;37;132;280.303.030.303.030.000;719.696.969.696.969.000
5476;VARJ«O;GO;95;37;132;280.303.030.303.030.000;719.696.969.696.969.000
1720;ESPUMOSO;RS;113;44;157;280.254.777.070.063.000;719.745.222.929.936.000
2258;IPORANGA;SP;131;51;182;280.219.780.219.780.000;719.780.219.780.219.000
148;ALTO ARAGUAIA;MT;149;58;207;280.193.236.714.975.000;719.806.763.285.024.000
2541;JAPONVAR;MG;149;58;207;280.193.236.714.975.000;719.806.763.285.024.000
4557;SANTIAGO;RS;167;65;232;280.172.413.793.103.000;719.827.586.206.896.000
1172;CASIMIRO DE ABREU;RJ;352;137;489;280.163.599.182.004.000;719.836.400.817.995.000
2476;JABOAT«O DOS GUARARAPES;PE;1462;569;2031;280.157.557.853.274.000;719.842.442.146.725.000
4583;SANTO ANT‚NIO DO DESCOBERTO;GO;532;207;739;280.108.254.397.834.000;719.891.745.602.165.000
1932;GOIANA;PE;455;177;632;280.063.291.139.240.000;719.936.708.860.759.000
1784;FERNANDES TOURINHO;MG;72;28;100;280.000.000.000.000.000;720.000.000.000.000.000
2269;IRACEMA;CE;90;35;125;280.000.000.000.000.000;720.000.000.000.000.000
2192;IMBê DE MINAS;MG;90;35;125;280.000.000.000.000.000;720.000.000.000.000.000
2111;IBICU÷;BA;126;49;175;280.000.000.000.000.000;720.000.000.000.000.000
2105;IBIAPINA;CE;108;42;150;280.000.000.000.000.000;720.000.000.000.000.000
1524;CURRAL NOVO DO PIAU÷;PI;54;21;75;280.000.000.000.000.000;720.000.000.000.000.000
235;ANDREL∂NDIA;MG;126;49;175;280.000.000.000.000.000;720.000.000.000.000.000
366;ARCOVERDE;PE;216;84;300;280.000.000.000.000.000;720.000.000.000.000.000
572;BEBEDOURO;SP;378;147;525;280.000.000.000.000.000;720.000.000.000.000.000
495;BAR«O DE GRAJAÈ;MA;108;42;150;280.000.000.000.000.000;720.000.000.000.000.000
784;BREJOL∂NDIA;BA;72;28;100;280.000.000.000.000.000;720.000.000.000.000.000
793;BRUMADO;BA;198;77;275;280.000.000.000.000.000;720.000.000.000.000.000
2435;ITAÈ;RN;54;21;75;280.000.000.000.000.000;720.000.000.000.000.000
3034;MATO VERDE;MG;108;42;150;280.000.000.000.000.000;720.000.000.000.000.000
4082;QUARA÷;RS;198;77;275;280.000.000.000.000.000;720.000.000.000.000.000
3564;PALMEIRINA;PE;90;35;125;280.000.000.000.000.000;720.000.000.000.000.000
3477;ORINDIÈVA;SP;108;42;150;280.000.000.000.000.000;720.000.000.000.000.000
3759;PEND“NCIAS;RN;108;42;150;280.000.000.000.000.000;720.000.000.000.000.000
3753;PEIXOTO DE AZEVEDO;MT;216;84;300;280.000.000.000.000.000;720.000.000.000.000.000
5482;VµRZEA ALEGRE;CE;90;35;125;280.000.000.000.000.000;720.000.000.000.000.000
5542;VILA L∂NGARO;RS;54;21;75;280.000.000.000.000.000;720.000.000.000.000.000
5179;TANQUE D'ARCA;AL;108;42;150;280.000.000.000.000.000;720.000.000.000.000.000
4670;S«O FRANCISCO;PB;54;21;75;280.000.000.000.000.000;720.000.000.000.000.000
4615;S«O BENEDITO DO SUL;PE;90;35;125;280.000.000.000.000.000;720.000.000.000.000.000
4833;S«O LEOPOLDO;RS;360;140;500;280.000.000.000.000.000;720.000.000.000.000.000
5092;SIMOL∂NDIA;GO;162;63;225;280.000.000.000.000.000;720.000.000.000.000.000
5129;SUCUPIRA DO NORTE;MA;72;28;100;280.000.000.000.000.000;720.000.000.000.000.000
1163;CASA BRANCA;SP;301;117;418;279.904.306.220.095.000;720.095.693.779.904.000
3523;PADRE BERNARDO;GO;283;110;393;279.898.218.829.516.000;720.101.781.170.483.000
2912;MANICORê;AM;247;96;343;279.883.381.924.198.000;720.116.618.075.801.000
5575;VIT‡RIA DO XINGU;PA;193;75;268;279.850.746.268.656.000;720.149.253.731.343.000
3456;OLHO D'µGUA DAS FLORES;AL;175;68;243;279.835.390.946.502.000;720.164.609.053.497.000
4376;SANTA BµRBARA;BA;175;68;243;279.835.390.946.502.000;720.164.609.053.497.000
833;CABO DE SANTO AGOSTINHO;PE;574;223;797;279.799.247.176.913.000;720.200.752.823.086.000
1849;FORTUNA DE MINAS;MG;139;54;193;279.792.746.113.989.000;720.207.253.886.010.000
3546;PALMARES;PE;417;162;579;279.792.746.113.989.000;720.207.253.886.010.000
2307;ITABORA÷;RJ;695;270;965;279.792.746.113.989.000;720.207.253.886.010.000
1445;COTIA;SP;538;209;747;279.785.809.906.291.000;720.214.190.093.708.000
135;ALTAMIRA;PA;363;141;504;279.761.904.761.904.000;720.238.095.238.095.000
15;ACAIACA;MG;121;47;168;279.761.904.761.904.000;720.238.095.238.095.000
3928;POMBAL;PB;121;47;168;279.761.904.761.904.000;720.238.095.238.095.000
3544;PALMA SOLA;SC;103;40;143;279.720.279.720.279.000;720.279.720.279.720.000
901;CAJAZEIRAS;PB;206;80;286;279.720.279.720.279.000;720.279.720.279.720.000
1396;COREMAS;PB;103;40;143;279.720.279.720.279.000;720.279.720.279.720.000
5000;SENADOR EL‡I DE SOUZA;RN;103;40;143;279.720.279.720.279.000;720.279.720.279.720.000
4030;PRATA;MG;188;73;261;279.693.486.590.038.000;720.306.513.409.961.000
5326;TR“S PONTAS;MG;461;179;640;279.687.500.000.000.000;720.312.500.000.000.000
2512;JAGUARIA÷VA;PR;273;106;379;279.683.377.308.707.000;720.316.622.691.292.000
4057;PRESIDENTE PRUDENTE;SP;528;205;733;279.672.578.444.747.000;720.327.421.555.252.000
4402;SANTA CRUZ DA VIT‡RIA;BA;85;33;118;279.661.016.949.152.000;720.338.983.050.847.000
4459;SANTA MARIA;RN;85;33;118;279.661.016.949.152.000;720.338.983.050.847.000
1518;CURITIBANOS;SC;170;66;236;279.661.016.949.152.000;720.338.983.050.847.000
1545;DELFIN‡POLIS;MG;85;33;118;279.661.016.949.152.000;720.338.983.050.847.000
1076;CAPINZAL;SC;85;33;118;279.661.016.949.152.000;720.338.983.050.847.000
2328;ITA÷;SP;322;125;447;279.642.058.165.548.000;720.357.941.834.451.000
4146;REGIN‡POLIS;SP;152;59;211;279.620.853.080.568.000;720.379.146.919.431.000
1443;COSTA RICA;MS;152;59;211;279.620.853.080.568.000;720.379.146.919.431.000
61;µGUA PRETA;PE;219;85;304;279.605.263.157.894.000;720.394.736.842.105.000
4689;S«O GABRIEL;RS;286;111;397;279.596.977.329.974.000;720.403.022.670.025.000
260;ANT‚NIO ALMEIDA;PI;67;26;93;279.569.892.473.118.000;720.430.107.526.881.000
3211;MORRO REUTER;RS;67;26;93;279.569.892.473.118.000;720.430.107.526.881.000
5089;SIM«O PEREIRA;MG;134;52;186;279.569.892.473.118.000;720.430.107.526.881.000
1546;DELMIRO GOUVEIA;AL;183;71;254;279.527.559.055.118.000;720.472.440.944.881.000
4774;S«O JOSê DA BELA VISTA;SP;183;71;254;279.527.559.055.118.000;720.472.440.944.881.000
96;ALBERTINA;MG;116;45;161;279.503.105.590.062.000;720.496.894.409.937.000
5503;VERA CRUZ;BA;348;135;483;279.503.105.590.062.000;720.496.894.409.937.000
4361;SALVADOR;BA;2372;920;3292;279.465.370.595.382.000;720.534.629.404.617.000
71;µGUAS FORMOSAS;MG;214;83;297;279.461.279.461.279.000;720.538.720.538.720.000
2099;IBEMA;PR;147;57;204;279.411.764.705.882.000;720.588.235.294.117.000
3723;PEDRA PRETA;MT;196;76;272;279.411.764.705.882.000;720.588.235.294.117.000
2746;LAJINHA;MG;98;38;136;279.411.764.705.882.000;720.588.235.294.117.000
5183;TAPARUBA;MG;98;38;136;279.411.764.705.882.000;720.588.235.294.117.000
5033;SERRA DA SAUDADE;MG;49;19;68;279.411.764.705.882.000;720.588.235.294.117.000
5141;TABA÷;RS;98;38;136;279.411.764.705.882.000;720.588.235.294.117.000
1376;CONSELHEIRO PENA;MG;227;88;315;279.365.079.365.079.000;720.634.920.634.920.000
3482;ORLEANS;SC;129;50;179;279.329.608.938.547.000;720.670.391.061.452.000
4090;QUATRO IRM«OS;RS;80;31;111;279.279.279.279.279.000;720.720.720.720.720.000
3270;NAZARê DO PIAU÷;PI;80;31;111;279.279.279.279.279.000;720.720.720.720.720.000
3306;NOVA ALIANÄA;SP;80;31;111;279.279.279.279.279.000;720.720.720.720.720.000
2958;MARCOS PARENTE;PI;80;31;111;279.279.279.279.279.000;720.720.720.720.720.000
598;BELO MONTE;AL;80;31;111;279.279.279.279.279.000;720.720.720.720.720.000
4987;SEBASTI«O LARANJEIRAS;BA;80;31;111;279.279.279.279.279.000;720.720.720.720.720.000
5453;VALE REAL;RS;80;31;111;279.279.279.279.279.000;720.720.720.720.720.000
2579;JEQUERI;MG;191;74;265;279.245.283.018.867.000;720.754.716.981.132.000
2627;JOSê GONÄALVES DE MINAS;MG;111;43;154;279.220.779.220.779.000;720.779.220.779.220.000
2755;LARANJAL;MG;111;43;154;279.220.779.220.779.000;720.779.220.779.220.000
4017;POUSO REDONDO;SC;111;43;154;279.220.779.220.779.000;720.779.220.779.220.000
689;BOM JESUS DO AMPARO;MG;111;43;154;279.220.779.220.779.000;720.779.220.779.220.000
2549;JARAGUARI;MS;142;55;197;279.187.817.258.883.000;720.812.182.741.116.000
5194;TAPIRA÷;SP;173;67;240;279.166.666.666.666.000;720.833.333.333.333.000
4343;SALGUEIRO;PE;235;91;326;279.141.104.294.478.000;720.858.895.705.521.000
5455;VALENÄA;BA;359;139;498;279.116.465.863.453.000;720.883.534.136.546.000
4197;RIBEIR«O DO LARGO;BA;124;48;172;279.069.767.441.860.000;720.930.232.558.139.000
3506;OURO VERDE;SP;155;60;215;279.069.767.441.860.000;720.930.232.558.139.000
2292;ISA÷AS COELHO;PI;62;24;86;279.069.767.441.860.000;720.930.232.558.139.000
2797;LINDOLFO COLLOR;RS;93;36;129;279.069.767.441.860.000;720.930.232.558.139.000
2969;MARIANA PIMENTEL;RS;93;36;129;279.069.767.441.860.000;720.930.232.558.139.000
3155;MONTE ALEGRE DE SERGIPE;SE;124;48;172;279.069.767.441.860.000;720.930.232.558.139.000
473;BALNEµRIO PIÄARRAS;SC;155;60;215;279.069.767.441.860.000;720.930.232.558.139.000
2193;IMBITUBA;SC;217;84;301;279.069.767.441.860.000;720.930.232.558.139.000
2268;IPUPIARA;BA;62;24;86;279.069.767.441.860.000;720.930.232.558.139.000
5541;VILA FLORES;RS;62;24;86;279.069.767.441.860.000;720.930.232.558.139.000
5175;TANGARµ;SC;93;36;129;279.069.767.441.860.000;720.930.232.558.139.000
3020;MATIAS CARDOSO;MG;168;65;233;278.969.957.081.545.000;721.030.042.918.454.000
2361;ITANAGRA;BA;168;65;233;278.969.957.081.545.000;721.030.042.918.454.000
2112;IBICUITINGA;CE;137;53;190;278.947.368.421.052.000;721.052.631.578.947.000
241;ANGICAL;BA;137;53;190;278.947.368.421.052.000;721.052.631.578.947.000
4135;RECIFE;PE;1869;723;2592;278.935.185.185.185.000;721.064.814.814.814.000
3972;PORTO ALEGRE;RS;1259;487;1746;278.923.253.150.057.000;721.076.746.849.942.000
2632;JUARA;MT;212;82;294;278.911.564.625.850.000;721.088.435.374.149.000
1502;CUITê DE MAMANGUAPE;PB;106;41;147;278.911.564.625.850.000;721.088.435.374.149.000
3893;PITIMBU;PB;181;70;251;278.884.462.151.394.000;721.115.537.848.605.000
3809;PILAR DE GOIµS;GO;75;29;104;278.846.153.846.153.000;721.153.846.153.846.000
3467;OLIVEDOS;PB;75;29;104;278.846.153.846.153.000;721.153.846.153.846.000
2275;IRA÷ DE MINAS;MG;75;29;104;278.846.153.846.153.000;721.153.846.153.846.000
5403;UMARIZAL;RN;75;29;104;278.846.153.846.153.000;721.153.846.153.846.000
5498;VENTANIA;PR;150;58;208;278.846.153.846.153.000;721.153.846.153.846.000
320;ARAGUAN«;TO;119;46;165;278.787.878.787.878.000;721.212.121.212.121.000
4661;S«O FêLIX DE MINAS;MG;119;46;165;278.787.878.787.878.000;721.212.121.212.121.000
2000;GUAMARê;RN;163;63;226;278.761.061.946.902.000;721.238.938.053.097.000
2920;MANTEN‡POLIS;ES;163;63;226;278.761.061.946.902.000;721.238.938.053.097.000
3106;MIRANDIBA;PE;176;68;244;278.688.524.590.163.000;721.311.475.409.836.000
2785;LIDIAN‡POLIS;PR;88;34;122;278.688.524.590.163.000;721.311.475.409.836.000
4222;RIO CASCA;MG;176;68;244;278.688.524.590.163.000;721.311.475.409.836.000
2179;ILHA DAS FLORES;SE;88;34;122;278.688.524.590.163.000;721.311.475.409.836.000
1607;DOM INOC“NCIO;PI;88;34;122;278.688.524.590.163.000;721.311.475.409.836.000
1577;DIVINA PASTORA;SE;88;34;122;278.688.524.590.163.000;721.311.475.409.836.000
1166;CASCA;RS;88;34;122;278.688.524.590.163.000;721.311.475.409.836.000
645;BOA VENTURA DE S«O ROQUE;PR;132;51;183;278.688.524.590.163.000;721.311.475.409.836.000
5506;VERA MENDES;PI;44;17;61;278.688.524.590.163.000;721.311.475.409.836.000
5343;TUCANO;BA;220;85;305;278.688.524.590.163.000;721.311.475.409.836.000
1120;CARIACICA;ES;756;292;1048;278.625.954.198.473.000;721.374.045.801.526.000
4528;SANTANA DA VARGEM;MG;145;56;201;278.606.965.174.129.000;721.393.034.825.870.000
3826;PINGO D'µGUA;MG;145;56;201;278.606.965.174.129.000;721.393.034.825.870.000
3003;MASSAP“;CE;101;39;140;278.571.428.571.428.000;721.428.571.428.571.000
2881;MAJOR ISIDORO;AL;101;39;140;278.571.428.571.428.000;721.428.571.428.571.000
3167;MONTE CASTELO;SP;101;39;140;278.571.428.571.428.000;721.428.571.428.571.000
3316;NOVA BANDEIRANTES;MT;202;78;280;278.571.428.571.428.000;721.428.571.428.571.000
36;AFONSO BEZERRA;RN;101;39;140;278.571.428.571.428.000;721.428.571.428.571.000
3163;MONTE BELO;MG;158;61;219;278.538.812.785.388.000;721.461.187.214.611.000
4710;S«O JER‚NIMO;RS;215;83;298;278.523.489.932.885.000;721.476.510.067.114.000
2450;ITIÈBA;BA;171;66;237;278.481.012.658.227.000;721.518.987.341.772.000
413;ASSIS BRASIL;AC;114;44;158;278.481.012.658.227.000;721.518.987.341.772.000
2062;GURUPµ;PA;114;44;158;278.481.012.658.227.000;721.518.987.341.772.000
2044;GUARIBA;SP;241;93;334;278.443.113.772.455.000;721.556.886.227.544.000
2584;JEQUITINHONHA;MG;241;93;334;278.443.113.772.455.000;721.556.886.227.544.000
412;ASSIS;SP;425;164;589;278.438.030.560.271.000;721.561.969.439.728.000
1937;GOIANêSIA DO PARµ;PA;184;71;255;278.431.372.549.019.000;721.568.627.450.980.000
469;BALNEµRIO ARROIO DO SILVA;SC;127;49;176;278.409.090.909.090.000;721.590.909.090.909.000
113;ALFREDO CHAVES;ES;127;49;176;278.409.090.909.090.000;721.590.909.090.909.000
2454;ITUAÄU;BA;127;49;176;278.409.090.909.090.000;721.590.909.090.909.000
4260;RIO PARANA÷BA;MG;127;49;176;278.409.090.909.090.000;721.590.909.090.909.000
4036;PRESIDENTE ALVES;SP;127;49;176;278.409.090.909.090.000;721.590.909.090.909.000
191;AMARAJI;PE;197;76;273;278.388.278.388.278.000;721.611.721.611.721.000
1311;COL÷DER;MT;197;76;273;278.388.278.388.278.000;721.611.721.611.721.000
1406;CORONEL BICACO;RS;70;27;97;278.350.515.463.917.000;721.649.484.536.082.000
3745;PEDRO LAURENTINO;PI;70;27;97;278.350.515.463.917.000;721.649.484.536.082.000
2469;IVAIPOR«;PR;210;81;291;278.350.515.463.917.000;721.649.484.536.082.000
3273;NAZAREZINHO;PB;70;27;97;278.350.515.463.917.000;721.649.484.536.082.000
2982;MARIN‡POLIS;SP;70;27;97;278.350.515.463.917.000;721.649.484.536.082.000
2946;MARAU;RS;153;59;212;278.301.886.792.452.000;721.698.113.207.547.000
375;AREIAS;SP;153;59;212;278.301.886.792.452.000;721.698.113.207.547.000
585;BELêM;PA;1774;684;2458;278.275.020.341.741.000;721.724.979.658.258.000
1352;CONCEIÄ«O DO TOCANTINS;TO;83;32;115;278.260.869.565.217.000;721.739.130.434.782.000
1268;CHAVANTES;SP;166;64;230;278.260.869.565.217.000;721.739.130.434.782.000
1597;DOIS RIACHOS;AL;83;32;115;278.260.869.565.217.000;721.739.130.434.782.000
2693;LAGO VERDE;MA;166;64;230;278.260.869.565.217.000;721.739.130.434.782.000
3867;PIRANHAS;GO;166;64;230;278.260.869.565.217.000;721.739.130.434.782.000
1404;COROMANDEL;MG;179;69;248;278.225.806.451.612.000;721.774.193.548.387.000
5189;TAPEROµ;BA;179;69;248;278.225.806.451.612.000;721.774.193.548.387.000
1340;CONCEIÄ«O DE IPANEMA;MG;96;37;133;278.195.488.721.804.000;721.804.511.278.195.000
2303;ITABI;SE;96;37;133;278.195.488.721.804.000;721.804.511.278.195.000
2345;ITAJU÷PE;BA;192;74;266;278.195.488.721.804.000;721.804.511.278.195.000
2242;IPIAÄU;MG;109;42;151;278.145.695.364.238.000;721.854.304.635.761.000
5218;TAUµ;CE;109;42;151;278.145.695.364.238.000;721.854.304.635.761.000
5113;SOL∂NEA;PB;109;42;151;278.145.695.364.238.000;721.854.304.635.761.000
1911;GENERAL CARNEIRO;MT;122;47;169;278.106.508.875.739.000;721.893.491.124.260.000
3782;PESCADOR;MG;122;47;169;278.106.508.875.739.000;721.893.491.124.260.000
4574;SANTO ANT‚NIO DE GOIµS;GO;122;47;169;278.106.508.875.739.000;721.893.491.124.260.000
3603;PARA÷SO DO TOCANTINS;TO;257;99;356;278.089.887.640.449.000;721.910.112.359.550.000
4521;SANTA VIT‡RIA;MG;148;57;205;278.048.780.487.804.000;721.951.219.512.195.000
4326;SABINO;SP;148;57;205;278.048.780.487.804.000;721.951.219.512.195.000
2459;ITUMIRIM;MG;148;57;205;278.048.780.487.804.000;721.951.219.512.195.000
3407;NOVA VENEZA;GO;161;62;223;278.026.905.829.596.000;721.973.094.170.403.000
783;BREJÂES;BA;187;72;259;277.992.277.992.277.000;722.007.722.007.722.000
1488;CRUZEIRO;SP;421;162;583;277.873.070.325.900.000;722.126.929.674.099.000
1592;DOIS IRM«OS;RS;104;40;144;277.777.777.777.777.000;722.222.222.222.222.000
1620;DONA IN“S;PB;91;35;126;277.777.777.777.777.000;722.222.222.222.222.000
1839;FORQUETINHA;RS;78;30;108;277.777.777.777.777.000;722.222.222.222.222.000
2237;IPAUSSU;SP;221;85;306;277.777.777.777.777.000;722.222.222.222.222.000
2201;INAJµ;PE;130;50;180;277.777.777.777.777.000;722.222.222.222.222.000
2031;GUARANT«;SP;182;70;252;277.777.777.777.777.000;722.222.222.222.222.000
729;BOQUIRA;BA;130;50;180;277.777.777.777.777.000;722.222.222.222.222.000
633;BIRITINGA;BA;104;40;144;277.777.777.777.777.000;722.222.222.222.222.000
1123;CARINHANHA;BA;221;85;306;277.777.777.777.777.000;722.222.222.222.222.000
1140;CARMO DO PARANA÷BA;MG;143;55;198;277.777.777.777.777.000;722.222.222.222.222.000
1026;C∂NDIDO DE ABREU;PR;130;50;180;277.777.777.777.777.000;722.222.222.222.222.000
1042;CANITAR;SP;117;45;162;277.777.777.777.777.000;722.222.222.222.222.000
492;BAR«O DE ANTONINA;SP;78;30;108;277.777.777.777.777.000;722.222.222.222.222.000
122;ALMAS;TO;78;30;108;277.777.777.777.777.000;722.222.222.222.222.000
29;AÄUCENA;MG;156;60;216;277.777.777.777.777.000;722.222.222.222.222.000
3296;NORTEL∂NDIA;MT;78;30;108;277.777.777.777.777.000;722.222.222.222.222.000
3357;NOVA LACERDA;MT;143;55;198;277.777.777.777.777.000;722.222.222.222.222.000
3161;MONTE AZUL;MG;104;40;144;277.777.777.777.777.000;722.222.222.222.222.000
2913;MANOEL EM÷DIO;PI;65;25;90;277.777.777.777.777.000;722.222.222.222.222.000
2494;JACINTO MACHADO;SC;78;30;108;277.777.777.777.777.000;722.222.222.222.222.000
2726;LAGOA SECA;PB;130;50;180;277.777.777.777.777.000;722.222.222.222.222.000
4360;SALTO VELOSO;SC;52;20;72;277.777.777.777.777.000;722.222.222.222.222.000
4007;POSSE;GO;208;80;288;277.777.777.777.777.000;722.222.222.222.222.000
4157;RESERVA DO IGUAÄU;PR;117;45;162;277.777.777.777.777.000;722.222.222.222.222.000
3812;PILÂES;PB;91;35;126;277.777.777.777.777.000;722.222.222.222.222.000
3786;PETROL∂NDIA;SC;52;20;72;277.777.777.777.777.000;722.222.222.222.222.000
5139;SUZANµPOLIS;SP;91;35;126;277.777.777.777.777.000;722.222.222.222.222.000
4915;S«O ROQUE DO CANA«;ES;143;55;198;277.777.777.777.777.000;722.222.222.222.222.000
4675;S«O FRANCISCO DE GOIµS;GO;156;60;216;277.777.777.777.777.000;722.222.222.222.222.000
5281;TIROS;MG;78;30;108;277.777.777.777.777.000;722.222.222.222.222.000
5354;TUNTUM;MA;91;35;126;277.777.777.777.777.000;722.222.222.222.222.000
5558;VIRGOL∂NDIA;MG;91;35;126;277.777.777.777.777.000;722.222.222.222.222.000
2503;JACUTINGA;MG;216;83;299;277.591.973.244.147.000;722.408.026.755.852.000
1571;DION÷SIO;MG;190;73;263;277.566.539.923.954.000;722.433.460.076.045.000
2893;MAMBOR“;PR;177;68;245;277.551.020.408.163.000;722.448.979.591.836.000
1493;CRUZEIRO DO SUL;AC;341;131;472;277.542.372.881.355.000;722.457.627.118.644.000
3045;MAUµ DA SERRA;PR;164;63;227;277.533.039.647.577.000;722.466.960.352.422.000
4254;RIO MARIA;PA;164;63;227;277.533.039.647.577.000;722.466.960.352.422.000
3690;PAULISTA;PE;768;295;1063;277.516.462.841.015.000;722.483.537.158.984.000
3516;PACAJUS;CE;375;144;519;277.456.647.398.843.000;722.543.352.601.156.000
2449;ITIRUÄU;BA;125;48;173;277.456.647.398.843.000;722.543.352.601.156.000
715;BONFIN‡POLIS;GO;125;48;173;277.456.647.398.843.000;722.543.352.601.156.000
4873;S«O MIGUEL DO GUAMµ;PA;349;134;483;277.432.712.215.320.000;722.567.287.784.679.000
285;APORµ;BA;112;43;155;277.419.354.838.709.000;722.580.645.161.290.000
2872;MAGALH«ES DE ALMEIDA;MA;112;43;155;277.419.354.838.709.000;722.580.645.161.290.000
3440;NOVO S«O JOAQUIM;MT;112;43;155;277.419.354.838.709.000;722.580.645.161.290.000
4503;SANTA ROSA DO PURUS;AC;112;43;155;277.419.354.838.709.000;722.580.645.161.290.000
2160;IGARAPê-MIRI;PA;323;124;447;277.404.921.700.223.000;722.595.078.299.776.000
2001;GUAMIRANGA;PR;99;38;137;277.372.262.773.722.000;722.627.737.226.277.000
2015;GUARACI;PR;99;38;137;277.372.262.773.722.000;722.627.737.226.277.000
1843;FORTALEZA DE MINAS;MG;99;38;137;277.372.262.773.722.000;722.627.737.226.277.000
1675;ENGENHEIRO BELTR«O;PR;198;76;274;277.372.262.773.722.000;722.627.737.226.277.000
814;BURITIN‡POLIS;GO;99;38;137;277.372.262.773.722.000;722.627.737.226.277.000
3813;PILÂEZINHOS;PB;99;38;137;277.372.262.773.722.000;722.627.737.226.277.000
3100;MIRADOURO;MG;99;38;137;277.372.262.773.722.000;722.627.737.226.277.000
3115;MIRASSOL D'OESTE;MT;198;76;274;277.372.262.773.722.000;722.627.737.226.277.000
2305;ITABIRINHA;MG;99;38;137;277.372.262.773.722.000;722.627.737.226.277.000
2169;IGUAPE;SP;284;109;393;277.353.689.567.430.000;722.646.310.432.569.000
1906;GAVI«O;BA;86;33;119;277.310.924.369.747.000;722.689.075.630.252.000
733;BORBOREMA;SP;172;66;238;277.310.924.369.747.000;722.689.075.630.252.000
2442;ITAÈNA DO SUL;PR;86;33;119;277.310.924.369.747.000;722.689.075.630.252.000
3235;MUNHOZ;MG;86;33;119;277.310.924.369.747.000;722.689.075.630.252.000
4573;SANTO ANT‚NIO DAS MISSÂES;RS;86;33;119;277.310.924.369.747.000;722.689.075.630.252.000
5040;SERRA DOURADA;BA;86;33;119;277.310.924.369.747.000;722.689.075.630.252.000
2835;LUZ;MG;245;94;339;277.286.135.693.215.000;722.713.864.306.784.000
756;BRASIL∂NDIA DE MINAS;MG;159;61;220;277.272.727.272.727.000;722.727.272.727.272.000
5394;UBIRAT«;PR;159;61;220;277.272.727.272.727.000;722.727.272.727.272.000
933;CAMBIRA;PR;146;56;202;277.227.722.772.277.000;722.772.277.227.722.000
2190;IMBAÈ;PR;146;56;202;277.227.722.772.277.000;722.772.277.227.722.000
3390;NOVA ROSAL∂NDIA;TO;73;28;101;277.227.722.772.277.000;722.772.277.227.722.000
3526;PADRE PARA÷SO;MG;219;84;303;277.227.722.772.277.000;722.772.277.227.722.000
4378;SANTA BµRBARA DE GOIµS;GO;146;56;202;277.227.722.772.277.000;722.772.277.227.722.000
5231;TELHA;SE;73;28;101;277.227.722.772.277.000;722.772.277.227.722.000
4005;PORTO WALTER;AC;133;51;184;277.173.913.043.478.000;722.826.086.956.521.000
808;BURITI BRAVO;MA;133;51;184;277.173.913.043.478.000;722.826.086.956.521.000
5586;WENCESLAU BRAZ;MG;133;51;184;277.173.913.043.478.000;722.826.086.956.521.000
4898;S«O PEDRO DO IGUAÄU;PR;133;51;184;277.173.913.043.478.000;722.826.086.956.521.000
4954;S«O VICENTE DO SERID‡;PB;133;51;184;277.173.913.043.478.000;722.826.086.956.521.000
4290;ROL∂NDIA;PR;253;97;350;277.142.857.142.857.000;722.857.142.857.142.000
4287;RODOLFO FERNANDES;RN;60;23;83;277.108.433.734.939.000;722.891.566.265.060.000
2618;JOCA MARQUES;PI;60;23;83;277.108.433.734.939.000;722.891.566.265.060.000
2370;ITAOCARA;RJ;240;92;332;277.108.433.734.939.000;722.891.566.265.060.000
758;BRASIL∂NDIA DO TOCANTINS;TO;60;23;83;277.108.433.734.939.000;722.891.566.265.060.000
1044;CANOINHAS;SC;240;92;332;277.108.433.734.939.000;722.891.566.265.060.000
1517;CURITIBA;PR;2004;768;2772;277.056.277.056.277.000;722.943.722.943.722.000
4470;SANTA MARIA DO PARµ;PA;167;64;231;277.056.277.056.277.000;722.943.722.943.722.000
592;BELMIRO BRAGA;MG;107;41;148;277.027.027.027.027.000;722.972.972.972.972.000
5508;VERDEJANTE;PE;107;41;148;277.027.027.027.027.000;722.972.972.972.972.000
599;BELO ORIENTE;MG;261;100;361;277.008.310.249.307.000;722.991.689.750.692.000
2898;MANAQUIRI;AM;201;77;278;276.978.417.266.187.000;723.021.582.733.812.000
5323;TR“S MARIAS;MG;201;77;278;276.978.417.266.187.000;723.021.582.733.812.000
1155;CARPINA;PE;449;172;621;276.972.624.798.711.000;723.027.375.201.288.000
853;CACHOEIRA DO SUL;RS;295;113;408;276.960.784.313.725.000;723.039.215.686.274.000
1613;DOM SILVêRIO;MG;94;36;130;276.923.076.923.076.000;723.076.923.076.923.000
1786;FERNANDO PEDROZA;RN;94;36;130;276.923.076.923.076.000;723.076.923.076.923.000
1806;FLORA RICA;SP;94;36;130;276.923.076.923.076.000;723.076.923.076.923.000
3925;POCRANE;MG;94;36;130;276.923.076.923.076.000;723.076.923.076.923.000
5601;XIQUE-XIQUE;BA;141;54;195;276.923.076.923.076.000;723.076.923.076.923.000
5079;SIGEFREDO PACHECO;PI;94;36;130;276.923.076.923.076.000;723.076.923.076.923.000
3321;NOVA BRASIL∂NDIA DO OESTE;RO;175;67;242;276.859.504.132.231.000;723.140.495.867.768.000
673;BOM JARDIM;PE;175;67;242;276.859.504.132.231.000;723.140.495.867.768.000
1286;CIPOT∂NEA;MG;128;49;177;276.836.158.192.090.000;723.163.841.807.909.000
3750;PEDRO VELHO;RN;128;49;177;276.836.158.192.090.000;723.163.841.807.909.000
4123;RAFAEL JAMBEIRO;BA;128;49;177;276.836.158.192.090.000;723.163.841.807.909.000
4265;RIO PRETO;MG;128;49;177;276.836.158.192.090.000;723.163.841.807.909.000
4298;RONDOL∂NDIA;MT;81;31;112;276.785.714.285.714.000;723.214.285.714.285.000
3719;PEDRA GRANDE;RN;81;31;112;276.785.714.285.714.000;723.214.285.714.285.000
1410;CORONEL FREITAS;SC;81;31;112;276.785.714.285.714.000;723.214.285.714.285.000
2152;IGAPOR«;BA;81;31;112;276.785.714.285.714.000;723.214.285.714.285.000
1041;CANINDê DE S«O FRANCISCO;SE;162;62;224;276.785.714.285.714.000;723.214.285.714.285.000
1056;CAPANEMA;PA;324;124;448;276.785.714.285.714.000;723.214.285.714.285.000
573;BEBERIBE;CE;243;93;336;276.785.714.285.714.000;723.214.285.714.285.000
4780;S«O JOSê DA SAFIRA;MG;81;31;112;276.785.714.285.714.000;723.214.285.714.285.000
5420;UNIFLOR;PR;81;31;112;276.785.714.285.714.000;723.214.285.714.285.000
3274;NAZµRIA;PI;196;75;271;276.752.767.527.675.000;723.247.232.472.324.000
4106;QUINTA DO SOL;PR;115;44;159;276.729.559.748.427.000;723.270.440.251.572.000
1051;CANTO DO BURITI;PI;115;44;159;276.729.559.748.427.000;723.270.440.251.572.000
4546;SANTANA DO PARA÷SO;MG;298;114;412;276.699.029.126.213.000;723.300.970.873.786.000
4138;REDENÄ«O;PA;421;161;582;276.632.302.405.498.000;723.367.697.594.501.000
3887;PIRITIBA;BA;136;52;188;276.595.744.680.851.000;723.404.255.319.148.000
3545;PALMµCIA;CE;170;65;235;276.595.744.680.851.000;723.404.255.319.148.000
3474;ONDA VERDE;SP;136;52;188;276.595.744.680.851.000;723.404.255.319.148.000
3329;NOVA CASTILHO;SP;68;26;94;276.595.744.680.851.000;723.404.255.319.148.000
2325;ITAGUARI;GO;102;39;141;276.595.744.680.851.000;723.404.255.319.148.000
2526;JANDAIA DO SUL;PR;204;78;282;276.595.744.680.851.000;723.404.255.319.148.000
2593;JIJOCA DE JERICOACOARA;CE;136;52;188;276.595.744.680.851.000;723.404.255.319.148.000
2580;JEQUIµ DA PRAIA;AL;102;39;141;276.595.744.680.851.000;723.404.255.319.148.000
1106;CARATINGA;MG;544;208;752;276.595.744.680.851.000;723.404.255.319.148.000
1375;CONSELHEIRO MAIRINCK;PR;102;39;141;276.595.744.680.851.000;723.404.255.319.148.000
1310;COLATINA;ES;408;156;564;276.595.744.680.851.000;723.404.255.319.148.000
1249;CH« GRANDE;PE;136;52;188;276.595.744.680.851.000;723.404.255.319.148.000
4601;SANTO ANT‚NIO DOS MILAGRES;PI;68;26;94;276.595.744.680.851.000;723.404.255.319.148.000
5290;TOMAR DO GERU;SE;102;39;141;276.595.744.680.851.000;723.404.255.319.148.000
2521;JALES;SP;225;86;311;276.527.331.189.710.000;723.472.668.810.289.000
305;ARACOIABA;CE;157;60;217;276.497.695.852.534.000;723.502.304.147.465.000
924;CAMAMU;BA;280;107;387;276.485.788.113.695.000;723.514.211.886.304.000
211;AMPARO DO SERRA;MG;123;47;170;276.470.588.235.294.000;723.529.411.764.705.000
2375;ITAPê;BA;123;47;170;276.470.588.235.294.000;723.529.411.764.705.000
2680;JUVEN÷LIA;MG;89;34;123;276.422.764.227.642.000;723.577.235.772.357.000
3435;NOVO PLANALTO;GO;89;34;123;276.422.764.227.642.000;723.577.235.772.357.000
3957;POPULINA;SP;89;34;123;276.422.764.227.642.000;723.577.235.772.357.000
5328;TR“S RIOS;RJ;466;178;644;276.397.515.527.950.000;723.602.484.472.049.000
458;BA÷A DA TRAIÄ«O;PB;144;55;199;276.381.909.547.738.000;723.618.090.452.261.000
202;AMERICANO DO BRASIL;GO;110;42;152;276.315.789.473.684.000;723.684.210.526.315.000
2102;IBIAÄµ;RS;55;21;76;276.315.789.473.684.000;723.684.210.526.315.000
3993;PORTO MAUµ;RS;55;21;76;276.315.789.473.684.000;723.684.210.526.315.000
4115;QUIXABA;PB;55;21;76;276.315.789.473.684.000;723.684.210.526.315.000
2446;ITIQUIRA;MT;165;63;228;276.315.789.473.684.000;723.684.210.526.315.000
3193;MOREIRA SALES;PR;110;42;152;276.315.789.473.684.000;723.684.210.526.315.000
5438;URUCUIA;MG;165;63;228;276.315.789.473.684.000;723.684.210.526.315.000
5192;TAPIRA;PR;110;42;152;276.315.789.473.684.000;723.684.210.526.315.000
2637;JUAZEIRO;BA;592;226;818;276.283.618.581.907.000;723.716.381.418.092.000
2147;IC‡;CE;186;71;257;276.264.591.439.688.000;723.735.408.560.311.000
4669;S«O FRANCISCO;MG;317;121;438;276.255.707.762.557.000;723.744.292.237.442.000
680;BOM JESUS;PI;131;50;181;276.243.093.922.651.000;723.756.906.077.348.000
2719;LAGOA GRANDE;MG;131;50;181;276.243.093.922.651.000;723.756.906.077.348.000
1617;DONA EMMA;SC;76;29;105;276.190.476.190.476.000;723.809.523.809.523.000
1946;GOIOXIM;PR;97;37;134;276.119.402.985.074.000;723.880.597.014.925.000
4234;RIO DO CAMPO;SC;97;37;134;276.119.402.985.074.000;723.880.597.014.925.000
2534;JAPARA÷BA;MG;139;53;192;276.041.666.666.666.000;723.958.333.333.333.000
2163;IGARATINGA;MG;139;53;192;276.041.666.666.666.000;723.958.333.333.333.000
713;BONFIM;MG;139;53;192;276.041.666.666.666.000;723.958.333.333.333.000
5143;TABAPU«;SP;139;53;192;276.041.666.666.666.000;723.958.333.333.333.000
422;ATALAIA DO NORTE;AM;202;77;279;275.985.663.082.437.000;724.014.336.917.562.000
5342;TUBAR«O;SC;370;141;511;275.929.549.902.152.000;724.070.450.097.847.000
433;AURIFLAMA;SP;126;48;174;275.862.068.965.517.000;724.137.931.034.482.000
2119;IBIRACATU;MG;105;40;145;275.862.068.965.517.000;724.137.931.034.482.000
1960;GOVERNADOR LOMANTO JÈNIOR;BA;42;16;58;275.862.068.965.517.000;724.137.931.034.482.000
1750;FAMA;MG;105;40;145;275.862.068.965.517.000;724.137.931.034.482.000
1579;DIVINO;MG;126;48;174;275.862.068.965.517.000;724.137.931.034.482.000
2899;MANARI;PE;105;40;145;275.862.068.965.517.000;724.137.931.034.482.000
4171;RIACHINHO;TO;84;32;116;275.862.068.965.517.000;724.137.931.034.482.000
4174;RIACHO DE SANTANA;BA;105;40;145;275.862.068.965.517.000;724.137.931.034.482.000
4495;SANTA RITA D'OESTE;SP;84;32;116;275.862.068.965.517.000;724.137.931.034.482.000
5262;TIBAGI;PR;168;64;232;275.862.068.965.517.000;724.137.931.034.482.000
4617;S«O BENTO;PB;84;32;116;275.862.068.965.517.000;724.137.931.034.482.000
4713;S«O JO«O;PR;63;24;87;275.862.068.965.517.000;724.137.931.034.482.000
684;BOM JESUS DA LAPA;BA;281;107;388;275.773.195.876.288.000;724.226.804.123.711.000
1945;GOIOER“;PR;218;83;301;275.747.508.305.647.000;724.252.491.694.352.000
4649;S«O DOMINGOS DO ARAGUAIA;PA;218;83;301;275.747.508.305.647.000;724.252.491.694.352.000
1484;CRUZ DO ESP÷RITO SANTO;PB;197;75;272;275.735.294.117.647.000;724.264.705.882.352.000
1462;CRISTAIS;MG;197;75;272;275.735.294.117.647.000;724.264.705.882.352.000
3872;PIRAPORA;MG;394;150;544;275.735.294.117.647.000;724.264.705.882.352.000
2087;IACIARA;GO;155;59;214;275.700.934.579.439.000;724.299.065.420.560.000
5410;UNA;BA;310;118;428;275.700.934.579.439.000;724.299.065.420.560.000
3289;NIQUEL∂NDIA;GO;360;137;497;275.653.923.541.247.000;724.346.076.458.752.000
4015;POUSO ALTO;MG;113;43;156;275.641.025.641.025.000;724.358.974.358.974.000
2820;LU÷S ALVES;SC;92;35;127;275.590.551.181.102.000;724.409.448.818.897.000
5014;SENHORA DE OLIVEIRA;MG;92;35;127;275.590.551.181.102.000;724.409.448.818.897.000
3451;OIAPOQUE;AP;255;97;352;275.568.181.818.181.000;724.431.818.181.818.000
3940;PONTALINA;GO;163;62;225;275.555.555.555.555.000;724.444.444.444.444.000
5412;UNI«O;PI;163;62;225;275.555.555.555.555.000;724.444.444.444.444.000
3573;PALOTINA;PR;142;54;196;275.510.204.081.632.000;724.489.795.918.367.000
2206;INDEPEND“NCIA;RS;71;27;98;275.510.204.081.632.000;724.489.795.918.367.000
2261;IPUAÄU;SC;71;27;98;275.510.204.081.632.000;724.489.795.918.367.000
945;CAMPESTRE DA SERRA;RS;71;27;98;275.510.204.081.632.000;724.489.795.918.367.000
2164;IGRAPIÈNA;BA;192;73;265;275.471.698.113.207.000;724.528.301.886.792.000
1642;DUAS BARRAS;RJ;121;46;167;275.449.101.796.407.000;724.550.898.203.592.000
4213;RIO BANANAL;ES;121;46;167;275.449.101.796.407.000;724.550.898.203.592.000
479;BAMBU÷;MG;292;111;403;275.434.243.176.178.000;724.565.756.823.821.000
634;BITURUNA;PR;171;65;236;275.423.728.813.559.000;724.576.271.186.440.000
2754;LARANJA DA TERRA;ES;171;65;236;275.423.728.813.559.000;724.576.271.186.440.000
3418;NOVO CRUZEIRO;MG;250;95;345;275.362.318.840.579.000;724.637.681.159.420.000
3701;PAULO RAMOS;MA;100;38;138;275.362.318.840.579.000;724.637.681.159.420.000
3569;PALMITAL;PR;100;38;138;275.362.318.840.579.000;724.637.681.159.420.000
3830;PINHAL DE S«O BENTO;PR;50;19;69;275.362.318.840.579.000;724.637.681.159.420.000
335;ARAPONGA;MG;100;38;138;275.362.318.840.579.000;724.637.681.159.420.000
1474;CRISTINO CASTRO;PI;150;57;207;275.362.318.840.579.000;724.637.681.159.420.000
2014;GUARAÄA÷;SP;100;38;138;275.362.318.840.579.000;724.637.681.159.420.000
5210;TARABAI;SP;179;68;247;275.303.643.724.696.000;724.696.356.275.303.000
1156;CARRANCAS;MG;129;49;178;275.280.898.876.404.000;724.719.101.123.595.000
496;BAR«O DE MELGAÄO;MT;129;49;178;275.280.898.876.404.000;724.719.101.123.595.000
3870;PIRAPETINGA;MG;129;49;178;275.280.898.876.404.000;724.719.101.123.595.000
3030;MATO GROSSO DO SUL;MS;890;338;1228;275.244.299.674.267.000;724.755.700.325.732.000
2669;JURUAIA;MG;108;41;149;275.167.785.234.899.000;724.832.214.765.100.000
2656;JUNQUEIRO;AL;108;41;149;275.167.785.234.899.000;724.832.214.765.100.000
5216;TASSO FRAGOSO;MA;108;41;149;275.167.785.234.899.000;724.832.214.765.100.000
2355;ITAMBê;BA;174;66;240;275.000.000.000.000.000;725.000.000.000.000.000
2425;ITARUM«;GO;87;33;120;275.000.000.000.000.000;725.000.000.000.000.000
3927;POLONI;SP;87;33;120;275.000.000.000.000.000;725.000.000.000.000.000
3642;PARISI;SP;87;33;120;275.000.000.000.000.000;725.000.000.000.000.000
4205;RIBEIR«OZINHO;MT;58;22;80;275.000.000.000.000.000;725.000.000.000.000.000
558;BARROL∂NDIA;TO;87;33;120;275.000.000.000.000.000;725.000.000.000.000.000
889;CAIÄARA;RS;87;33;120;275.000.000.000.000.000;725.000.000.000.000.000
1424;C‡RREGO DO OURO;GO;58;22;80;275.000.000.000.000.000;725.000.000.000.000.000
1434;CORUMBA÷BA;GO;87;33;120;275.000.000.000.000.000;725.000.000.000.000.000
1733;ESTRELA DO NORTE;SP;116;44;160;275.000.000.000.000.000;725.000.000.000.000.000
4622;S«O BENTO DO SUL;SC;290;110;400;275.000.000.000.000.000;725.000.000.000.000.000
5098;SIRINHAêM;PE;182;69;251;274.900.398.406.374.000;725.099.601.593.625.000
1229;CENTRAL DO MARANH«O;MA;153;58;211;274.881.516.587.677.000;725.118.483.412.322.000
2401;ITAPIÈNA;CE;153;58;211;274.881.516.587.677.000;725.118.483.412.322.000
5409;UMUARAMA;PR;306;116;422;274.881.516.587.677.000;725.118.483.412.322.000
1640;DRACENA;SP;277;105;382;274.869.109.947.643.000;725.130.890.052.356.000
237;ANGEL∂NDIA;MG;124;47;171;274.853.801.169.590.000;725.146.198.830.409.000
3550;PALMAS;PR;248;94;342;274.853.801.169.590.000;725.146.198.830.409.000
4186;RIBEIRA;SP;95;36;131;274.809.160.305.343.000;725.190.839.694.656.000
3092;MINISTRO ANDREAZZA;RO;95;36;131;274.809.160.305.343.000;725.190.839.694.656.000
441;AVANHANDAVA;SP;190;72;262;274.809.160.305.343.000;725.190.839.694.656.000
5465;VARGEM;SC;95;36;131;274.809.160.305.343.000;725.190.839.694.656.000
2384;ITAPERUNA;RJ;417;158;575;274.782.608.695.652.000;725.217.391.304.347.000
2291;IRUPI;ES;161;61;222;274.774.774.774.774.000;725.225.225.225.225.000
370;AREIA;PB;227;86;313;274.760.383.386.581.000;725.239.616.613.418.000
2998;MARTINS SOARES;MG;132;50;182;274.725.274.725.274.000;725.274.725.274.725.000
3454;OLHO D'µGUA;PB;66;25;91;274.725.274.725.274.000;725.274.725.274.725.000
3592;PARA÷;RS;66;25;91;274.725.274.725.274.000;725.274.725.274.725.000
3829;PINHAL DA SERRA;RS;66;25;91;274.725.274.725.274.000;725.274.725.274.725.000
5395;UBIRETAMA;RS;66;25;91;274.725.274.725.274.000;725.274.725.274.725.000
5043;SERRA NEGRA DO NORTE;RN;66;25;91;274.725.274.725.274.000;725.274.725.274.725.000
4722;S«O JO«O DA LAGOA;MG;132;50;182;274.725.274.725.274.000;725.274.725.274.725.000
4444;SANTA LEOPOLDINA;ES;169;64;233;274.678.111.587.982.000;725.321.888.412.017.000
3073;MIGUEL CALMON;BA;169;64;233;274.678.111.587.982.000;725.321.888.412.017.000
977;CAMPO FORMOSO;BA;169;64;233;274.678.111.587.982.000;725.321.888.412.017.000
621;BERURI;AM;169;64;233;274.678.111.587.982.000;725.321.888.412.017.000
708;BOM SUCESSO;PR;169;64;233;274.678.111.587.982.000;725.321.888.412.017.000
193;AMARALINA;GO;103;39;142;274.647.887.323.943.000;725.352.112.676.056.000
1618;DONA EUSêBIA;MG;103;39;142;274.647.887.323.943.000;725.352.112.676.056.000
2373;ITAPAGIPE;MG;103;39;142;274.647.887.323.943.000;725.352.112.676.056.000
3261;NATIVIDADE;RJ;243;92;335;274.626.865.671.641.000;725.373.134.328.358.000
4837;S«O LOURENÄO DO OESTE;SC;140;53;193;274.611.398.963.730.000;725.388.601.036.269.000
2039;GUARATINGA;BA;177;67;244;274.590.163.934.426.000;725.409.836.065.573.000
2610;JO«O PINHEIRO;MG;288;109;397;274.559.193.954.659.000;725.440.806.045.340.000
4835;S«O LOURENÄO DA MATA;PE;473;179;652;274.539.877.300.613.000;725.460.122.699.386.000
3182;MONTENEGRO;RS;259;98;357;274.509.803.921.568.000;725.490.196.078.431.000
4507;SANTA TERESA;ES;222;84;306;274.509.803.921.568.000;725.490.196.078.431.000
4288;RODRIGUES ALVES;AC;148;56;204;274.509.803.921.568.000;725.490.196.078.431.000
3831;PINHAL GRANDE;RS;74;28;102;274.509.803.921.568.000;725.490.196.078.431.000
3737;PEDRO AFONSO;TO;148;56;204;274.509.803.921.568.000;725.490.196.078.431.000
210;AMPARO DE S«O FRANCISCO;SE;74;28;102;274.509.803.921.568.000;725.490.196.078.431.000
1130;CARL‡POLIS;PR;222;84;306;274.509.803.921.568.000;725.490.196.078.431.000
1137;CARMO DA MATA;MG;185;70;255;274.509.803.921.568.000;725.490.196.078.431.000
5422;UPANEMA;RN;74;28;102;274.509.803.921.568.000;725.490.196.078.431.000
5313;TR“S ARROIOS;RS;74;28;102;274.509.803.921.568.000;725.490.196.078.431.000
653;BOA VISTA DO GURUPI;MA;156;59;215;274.418.604.651.162.000;725.581.395.348.837.000
1894;GARANHUNS;PE;312;118;430;274.418.604.651.162.000;725.581.395.348.837.000
3380;NOVA PETR‡POLIS;RS;156;59;215;274.418.604.651.162.000;725.581.395.348.837.000
2157;IGARAPê DO MEIO;MA;119;45;164;274.390.243.902.439.000;725.609.756.097.560.000
1280;C÷CERO DANTAS;BA;119;45;164;274.390.243.902.439.000;725.609.756.097.560.000
5197;TAPURAH;MT;119;45;164;274.390.243.902.439.000;725.609.756.097.560.000
1414;CORONEL MACEDO;SP;82;31;113;274.336.283.185.840.000;725.663.716.814.159.000
1695;ERMO;SC;82;31;113;274.336.283.185.840.000;725.663.716.814.159.000
2631;JOVI∂NIA;GO;82;31;113;274.336.283.185.840.000;725.663.716.814.159.000
2803;LIZARDA;TO;82;31;113;274.336.283.185.840.000;725.663.716.814.159.000
3969;PORTEL∂NDIA;GO;82;31;113;274.336.283.185.840.000;725.663.716.814.159.000
1016;CANARANA;BA;127;48;175;274.285.714.285.714.000;725.714.285.714.285.000
410;ASSA÷;PR;127;48;175;274.285.714.285.714.000;725.714.285.714.285.000
838;CABROB‡;PE;172;65;237;274.261.603.375.527.000;725.738.396.624.472.000
625;BEZERROS;PE;262;99;361;274.238.227.146.814.000;725.761.772.853.185.000
818;BURITIS;RO;225;85;310;274.193.548.387.096.000;725.806.451.612.903.000
1704;ESPERA FELIZ;MG;180;68;248;274.193.548.387.096.000;725.806.451.612.903.000
1230;CENTRALINA;MG;135;51;186;274.193.548.387.096.000;725.806.451.612.903.000
4024;PRADOS;MG;90;34;124;274.193.548.387.096.000;725.806.451.612.903.000
2772;LEANDRO FERREIRA;MG;135;51;186;274.193.548.387.096.000;725.806.451.612.903.000
4949;S«O VALêRIO DO TOCANTINS;TO;45;17;62;274.193.548.387.096.000;725.806.451.612.903.000
2539;JAPIRA;PR;143;54;197;274.111.675.126.903.000;725.888.324.873.096.000
2200;INAJµ;PR;98;37;135;274.074.074.074.074.000;725.925.925.925.925.000
4167;RIACH«O DO DANTAS;SE;151;57;208;274.038.461.538.461.000;725.961.538.461.538.000
2422;ITARARê;SP;355;134;489;274.028.629.856.850.000;725.971.370.143.149.000
3462;OL÷MPIA;SP;212;80;292;273.972.602.739.726.000;726.027.397.260.273.000
1810;FLORES;PE;106;40;146;273.972.602.739.726.000;726.027.397.260.273.000
482;BANANEIRAS;PB;106;40;146;273.972.602.739.726.000;726.027.397.260.273.000
5499;VENTUROSA;PE;106;40;146;273.972.602.739.726.000;726.027.397.260.273.000
3874;PIRAPOZINHO;SP;220;83;303;273.927.392.739.273.000;726.072.607.260.726.000
2626;JOSê DE FREITAS;PI;220;83;303;273.927.392.739.273.000;726.072.607.260.726.000
828;CABECEIRA GRANDE;MG;167;63;230;273.913.043.478.260.000;726.086.956.521.739.000
2128;IBIRAREMA;SP;114;43;157;273.885.350.318.471.000;726.114.649.681.528.000
3769;PEREIRA BARRETO;SP;228;86;314;273.885.350.318.471.000;726.114.649.681.528.000
5206;TAQUARITUBA;SP;228;86;314;273.885.350.318.471.000;726.114.649.681.528.000
133;ALTA FLORESTA DO OESTE;RO;175;66;241;273.858.921.161.825.000;726.141.078.838.174.000
200;AMêRICA DOURADA;BA;122;46;168;273.809.523.809.523.000;726.190.476.190.476.000
3838;PINHEIRINHO DO VALE;RS;61;23;84;273.809.523.809.523.000;726.190.476.190.476.000
3498;OURO;SC;61;23;84;273.809.523.809.523.000;726.190.476.190.476.000
3608;PARANµ;RN;61;23;84;273.809.523.809.523.000;726.190.476.190.476.000
4356;SALTO DO ITARARê;PR;122;46;168;273.809.523.809.523.000;726.190.476.190.476.000
3378;NOVA PALMA;RS;61;23;84;273.809.523.809.523.000;726.190.476.190.476.000
3303;NOSSA SENHORA DO LIVRAMENTO;MT;122;46;168;273.809.523.809.523.000;726.190.476.190.476.000
2984;MARI‡POLIS;PR;61;23;84;273.809.523.809.523.000;726.190.476.190.476.000
5518;VESPASIANO CORR“A;RS;61;23;84;273.809.523.809.523.000;726.190.476.190.476.000
4885;S«O PAULO DAS MISSÂES;RS;61;23;84;273.809.523.809.523.000;726.190.476.190.476.000
1853;FRANCA;SP;618;233;851;273.795.534.665.099.000;726.204.465.334.900.000
1646;DUQUE BACELAR;MA;130;49;179;273.743.016.759.776.000;726.256.983.240.223.000
850;CACHOEIRA DE PAJEÈ;MG;130;49;179;273.743.016.759.776.000;726.256.983.240.223.000
961;CAMPO ALEGRE;AL;199;75;274;273.722.627.737.226.000;726.277.372.262.773.000
4940;S«O THOMê DAS LETRAS;MG;199;75;274;273.722.627.737.226.000;726.277.372.262.773.000
1181;CASTEL∂NDIA;GO;69;26;95;273.684.210.526.315.000;726.315.789.473.684.000
1739;EUG“NIO DE CASTRO;RS;69;26;95;273.684.210.526.315.000;726.315.789.473.684.000
2696;LAGOA BONITA DO SUL;RS;69;26;95;273.684.210.526.315.000;726.315.789.473.684.000
2836;LUZERNA;SC;69;26;95;273.684.210.526.315.000;726.315.789.473.684.000
4787;S«O JOSê DE ESPINHARAS;PB;69;26;95;273.684.210.526.315.000;726.315.789.473.684.000
5533;VIDAL RAMOS;SC;69;26;95;273.684.210.526.315.000;726.315.789.473.684.000
476;BALSA NOVA;PR;215;81;296;273.648.648.648.648.000;726.351.351.351.351.000
3272;NAZARENO;MG;146;55;201;273.631.840.796.019.000;726.368.159.203.980.000
5115;SOLEDADE;PB;146;55;201;273.631.840.796.019.000;726.368.159.203.980.000
2879;MAIRIPOTABA;GO;77;29;106;273.584.905.660.377.000;726.415.094.339.622.000
2701;LAGOA DE DENTRO;PB;77;29;106;273.584.905.660.377.000;726.415.094.339.622.000
2681;KALORê;PR;77;29;106;273.584.905.660.377.000;726.415.094.339.622.000
4109;QUIPAPµ;PE;154;58;212;273.584.905.660.377.000;726.415.094.339.622.000
194;AMARANTE;PI;154;58;212;273.584.905.660.377.000;726.415.094.339.622.000
1968;GRACCHO CARDOSO;SE;77;29;106;273.584.905.660.377.000;726.415.094.339.622.000
1306;COIMBRA;MG;77;29;106;273.584.905.660.377.000;726.415.094.339.622.000
1326;COLORADO DO OESTE;RO;154;58;212;273.584.905.660.377.000;726.415.094.339.622.000
1558;DESTERRO DO MELO;MG;77;29;106;273.584.905.660.377.000;726.415.094.339.622.000
5501;VERA CRUZ;RS;154;58;212;273.584.905.660.377.000;726.415.094.339.622.000
5227;TEIXEIR‡POLIS;RO;77;29;106;273.584.905.660.377.000;726.415.094.339.622.000
4308;ROSµRIO DA LIMEIRA;MG;162;61;223;273.542.600.896.860.000;726.457.399.103.139.000
3865;PIRANGUÄU;MG;162;61;223;273.542.600.896.860.000;726.457.399.103.139.000
1628;DOURADINA;MS;85;32;117;273.504.273.504.273.000;726.495.726.495.726.000
381;ARICANDUVA;MG;85;32;117;273.504.273.504.273.000;726.495.726.495.726.000
5132;SUL BRASIL;SC;85;32;117;273.504.273.504.273.000;726.495.726.495.726.000
4748;S«O JO«O DO ORIENTE;MG;85;32;117;273.504.273.504.273.000;726.495.726.495.726.000
802;BUJARI;AC;178;67;245;273.469.387.755.102.000;726.530.612.244.897.000
467;BALDIM;MG;186;70;256;273.437.500.000.000.000;726.562.500.000.000.000
174;µLVARES FLORENCE;SP;93;35;128;273.437.500.000.000.000;726.562.500.000.000.000
23;ACEGUµ;RS;93;35;128;273.437.500.000.000.000;726.562.500.000.000.000
1983;GROSSOS;RN;93;35;128;273.437.500.000.000.000;726.562.500.000.000.000
4337;SALETE;SC;93;35;128;273.437.500.000.000.000;726.562.500.000.000.000
2712;LAGOA DO TOCANTINS;TO;93;35;128;273.437.500.000.000.000;726.562.500.000.000.000
2488;JACAREACANGA;PA;186;70;256;273.437.500.000.000.000;726.562.500.000.000.000
4644;S«O DOMINGOS;SC;93;35;128;273.437.500.000.000.000;726.562.500.000.000.000
4192;RIBEIR«O BRANCO;SP;194;73;267;273.408.239.700.374.000;726.591.760.299.625.000
3878;PIRATINI;RS;101;38;139;273.381.294.964.028.000;726.618.705.035.971.000
3579;PANTANO GRANDE;RS;101;38;139;273.381.294.964.028.000;726.618.705.035.971.000
4887;S«O PAULO DO POTENGI;RN;101;38;139;273.381.294.964.028.000;726.618.705.035.971.000
2866;MADRE DE DEUS DE MINAS;MG;109;41;150;273.333.333.333.333.000;726.666.666.666.666.000
2276;IRAJUBA;BA;109;41;150;273.333.333.333.333.000;726.666.666.666.666.000
4588;SANTO ANT‚NIO DO JARDIM;SP;109;41;150;273.333.333.333.333.000;726.666.666.666.666.000
4653;S«O DOMINGOS DO MARANH«O;MA;109;41;150;273.333.333.333.333.000;726.666.666.666.666.000
456;BAGRE;PA;226;85;311;273.311.897.106.109.000;726.688.102.893.890.000
1111;CARAVELAS;BA;226;85;311;273.311.897.106.109.000;726.688.102.893.890.000
3251;MUZAMBINHO;MG;226;85;311;273.311.897.106.109.000;726.688.102.893.890.000
4143;REDUTO;MG;117;44;161;273.291.925.465.838.000;726.708.074.534.161.000
1327;COLUNA;MG;117;44;161;273.291.925.465.838.000;726.708.074.534.161.000
2083;HUMAITµ;AM;242;91;333;273.273.273.273.273.000;726.726.726.726.726.000
504;BARBOSA FERRAZ;PR;125;47;172;273.255.813.953.488.000;726.744.186.046.511.000
4642;S«O DESIDêRIO;BA;133;50;183;273.224.043.715.846.000;726.775.956.284.153.000
1783;FERNANDES PINHEIRO;PR;141;53;194;273.195.876.288.659.000;726.804.123.711.340.000
5170;TAMBOARA;PR;141;53;194;273.195.876.288.659.000;726.804.123.711.340.000
5563;VISTA ALEGRE DO ALTO;SP;141;53;194;273.195.876.288.659.000;726.804.123.711.340.000
2130;IBIRITê;MG;604;227;831;273.164.861.612.515.000;726.835.138.387.484.000
2848;MACARANI;BA;157;59;216;273.148.148.148.148.000;726.851.851.851.851.000
3698;PAULO FRONTIN;PR;165;62;227;273.127.753.303.964.000;726.872.246.696.035.000
1449;COUTO DE MAGALH«ES DE MINAS;MG;165;62;227;273.127.753.303.964.000;726.872.246.696.035.000
262;ANT‚NIO CARLOS;MG;181;68;249;273.092.369.477.911.000;726.907.630.522.088.000
470;BALNEµRIO BARRA DO SUL;SC;189;71;260;273.076.923.076.923.000;726.923.076.923.076.000
3084;MINAÄU;GO;205;77;282;273.049.645.390.070.000;726.950.354.609.929.000
2731;LAGUNA;SC;237;89;326;273.006.134.969.325.000;726.993.865.030.674.000
2523;JAMPRUCA;MG;128;48;176;272.727.272.727.272.000;727.272.727.272.727.000
2283;IRARµ;BA;224;84;308;272.727.272.727.272.000;727.272.727.272.727.000
2321;ITAGUAÄU DA BAHIA;BA;96;36;132;272.727.272.727.272.000;727.272.727.272.727.000
3237;MUNIZ FERREIRA;BA;104;39;143;272.727.272.727.272.000;727.272.727.272.727.000
3249;MUTUM;MG;168;63;231;272.727.272.727.272.000;727.272.727.272.727.000
3325;NOVA CANA« DO NORTE;MT;128;48;176;272.727.272.727.272.000;727.272.727.272.727.000
3310;NOVA AMêRICA;GO;88;33;121;272.727.272.727.272.000;727.272.727.272.727.000
3484;OROC‡;PE;104;39;143;272.727.272.727.272.000;727.272.727.272.727.000
3922;POÄÂES;BA;232;87;319;272.727.272.727.272.000;727.272.727.272.727.000
3799;PICU÷;PB;96;36;132;272.727.272.727.272.000;727.272.727.272.727.000
3757;PENALVA;MA;176;66;242;272.727.272.727.272.000;727.272.727.272.727.000
3722;PEDRA PRETA;RN;64;24;88;272.727.272.727.272.000;727.272.727.272.727.000
4168;RIACH«O DO JACU÷PE;BA;160;60;220;272.727.272.727.272.000;727.272.727.272.727.000
4246;RIO FORTUNA;SC;56;21;77;272.727.272.727.272.000;727.272.727.272.727.000
4019;PRACINHA;SP;96;36;132;272.727.272.727.272.000;727.272.727.272.727.000
4346;SALIN‡POLIS;PA;296;111;407;272.727.272.727.272.000;727.272.727.272.727.000
4380;SANTA BµRBARA DO MONTE VERDE;MG;80;30;110;272.727.272.727.272.000;727.272.727.272.727.000
4409;SANTA CRUZ DO CAPIBARIBE;PE;184;69;253;272.727.272.727.272.000;727.272.727.272.727.000
4430;SANTA HELENA;SC;72;27;99;272.727.272.727.272.000;727.272.727.272.727.000
533;BARRA DO RIO AZUL;RS;56;21;77;272.727.272.727.272.000;727.272.727.272.727.000
409;ASPµSIA;SP;64;24;88;272.727.272.727.272.000;727.272.727.272.727.000
277;APARECIDA D'OESTE;SP;64;24;88;272.727.272.727.272.000;727.272.727.272.727.000
91;ALAGOINHA;PE;72;27;99;272.727.272.727.272.000;727.272.727.272.727.000
1054;CANUTAMA;AM;128;48;176;272.727.272.727.272.000;727.272.727.272.727.000
949;CAMPINA DAS MISSÂES;RS;64;24;88;272.727.272.727.272.000;727.272.727.272.727.000
861;CACHOEIRINHA;PE;88;33;121;272.727.272.727.272.000;727.272.727.272.727.000
1707;ESPERANÄA NOVA;PR;72;27;99;272.727.272.727.272.000;727.272.727.272.727.000
1292;CLEMENTINA;SP;96;36;132;272.727.272.727.272.000;727.272.727.272.727.000
1183;CASTELO DO PIAU÷;PI;88;33;121;272.727.272.727.272.000;727.272.727.272.727.000
2245;IPIRA;SC;56;21;77;272.727.272.727.272.000;727.272.727.272.727.000
2123;IBIRAJUBA;PE;64;24;88;272.727.272.727.272.000;727.272.727.272.727.000
2043;GUARE÷;SP;160;60;220;272.727.272.727.272.000;727.272.727.272.727.000
2055;GUIMAR«ES;MA;176;66;242;272.727.272.727.272.000;727.272.727.272.727.000
1732;ESTRELA DO NORTE;GO;80;30;110;272.727.272.727.272.000;727.272.727.272.727.000
1895;GARARU;SE;96;36;132;272.727.272.727.272.000;727.272.727.272.727.000
1917;GETULINA;SP;192;72;264;272.727.272.727.272.000;727.272.727.272.727.000
1859;FRANCISCO DANTAS;RN;64;24;88;272.727.272.727.272.000;727.272.727.272.727.000
5271;TIMBê DO SUL;SC;64;24;88;272.727.272.727.272.000;727.272.727.272.727.000
4956;S«O VICENTE FERRER;PE;24;9;33;272.727.272.727.272.000;727.272.727.272.727.000
5013;SENHOR DO BONFIM;BA;296;111;407;272.727.272.727.272.000;727.272.727.272.727.000
5142;TABAPOR«;MT;144;54;198;272.727.272.727.272.000;727.272.727.272.727.000
5126;SOUSA;PB;232;87;319;272.727.272.727.272.000;727.272.727.272.727.000
5100;S÷TIO D'ABADIA;GO;72;27;99;272.727.272.727.272.000;727.272.727.272.727.000
5105;S÷TIO NOVO DO TOCANTINS;TO;104;39;143;272.727.272.727.272.000;727.272.727.272.727.000
5103;S÷TIO NOVO;MA;104;39;143;272.727.272.727.272.000;727.272.727.272.727.000
310;ARAÄUA÷;MG;235;88;323;272.445.820.433.436.000;727.554.179.566.563.000
251;ANICUNS;GO;219;82;301;272.425.249.169.435.000;727.574.750.830.564.000
2246;IPIRµ;BA;179;67;246;272.357.723.577.235.000;727.642.276.422.764.000
2662;JURAMENTO;MG;171;64;235;272.340.425.531.914.000;727.659.574.468.085.000
4715;S«O JO«O BATISTA;SC;171;64;235;272.340.425.531.914.000;727.659.574.468.085.000
4556;SANTARêM NOVO;PA;163;61;224;272.321.428.571.428.000;727.678.571.428.571.000
4817;S«O JOSê DO RIO CLARO;MT;163;61;224;272.321.428.571.428.000;727.678.571.428.571.000
4540;SANTANA DO JACARê;MG;155;58;213;272.300.469.483.568.000;727.699.530.516.431.000
2769;LAVRAS DA MANGABEIRA;CE;155;58;213;272.300.469.483.568.000;727.699.530.516.431.000
4937;S«O SEPê;RS;155;58;213;272.300.469.483.568.000;727.699.530.516.431.000
4134;REBOUÄAS;PR;139;52;191;272.251.308.900.523.000;727.748.691.099.476.000
1936;GOIANêSIA;GO;278;104;382;272.251.308.900.523.000;727.748.691.099.476.000
582;BELA VISTA DO TOLDO;SC;139;52;191;272.251.308.900.523.000;727.748.691.099.476.000
4978;SAUBARA;BA;278;104;382;272.251.308.900.523.000;727.748.691.099.476.000
2467;IÈNA;ES;270;101;371;272.237.196.765.498.000;727.762.803.234.501.000
4279;RIVERSUL;SP;131;49;180;272.222.222.222.222.000;727.777.777.777.777.000
4232;RIO DE JANEIRO;RJ;9452;3535;12987;272.195.272.195.272.000;727.804.727.804.727.000
4070;PROFESSOR JAMIL;GO;123;46;169;272.189.349.112.426.000;727.810.650.887.573.000
5311;TREMEDAL;BA;123;46;169;272.189.349.112.426.000;727.810.650.887.573.000
2770;LAVRAS DO SUL;RS;115;43;158;272.151.898.734.177.000;727.848.101.265.822.000
600;BELO VALE;MG;115;43;158;272.151.898.734.177.000;727.848.101.265.822.000
1770;FEIRA DE SANTANA;BA;904;338;1242;272.141.706.924.315.000;727.858.293.075.684.000
114;ALFREDO MARCONDES;SP;107;40;147;272.108.843.537.414.000;727.891.156.462.585.000
5433;URUBURETAMA;CE;107;40;147;272.108.843.537.414.000;727.891.156.462.585.000
4770;S«O JORGE DO PATROC÷NIO;PR;107;40;147;272.108.843.537.414.000;727.891.156.462.585.000
157;ALTO LONGµ;PI;91;34;125;272.000.000.000.000.000;728.000.000.000.000.000
350;ARARIPE;CE;91;34;125;272.000.000.000.000.000;728.000.000.000.000.000
2732;LAGUNA CARAP«;MS;91;34;125;272.000.000.000.000.000;728.000.000.000.000.000
2473;IVOL∂NDIA;GO;91;34;125;272.000.000.000.000.000;728.000.000.000.000.000
4751;S«O JO«O DO PARA÷SO;MG;182;68;250;272.000.000.000.000.000;728.000.000.000.000.000
5242;TERENOS;MS;182;68;250;272.000.000.000.000.000;728.000.000.000.000.000
5547;VILA PAV«O;ES;182;68;250;272.000.000.000.000.000;728.000.000.000.000.000
1883;FUNIL∂NDIA;MG;174;65;239;271.966.527.196.652.000;728.033.472.803.347.000
1910;GENERAL CARNEIRO;PR;174;65;239;271.966.527.196.652.000;728.033.472.803.347.000
2483;JABOTICATUBAS;MG;257;96;353;271.954.674.220.963.000;728.045.325.779.036.000
3131;MOIPORµ;GO;83;31;114;271.929.824.561.403.000;728.070.175.438.596.000
4194;RIBEIR«O CLARO;PR;166;62;228;271.929.824.561.403.000;728.070.175.438.596.000
1211;CAXAMBU DO SUL;SC;83;31;114;271.929.824.561.403.000;728.070.175.438.596.000
5272;TIMBIRAS;MA;249;93;342;271.929.824.561.403.000;728.070.175.438.596.000
5263;TIBAU;RN;83;31;114;271.929.824.561.403.000;728.070.175.438.596.000
1226;CENTENµRIO DO SUL;PR;158;59;217;271.889.400.921.658.000;728.110.599.078.341.000
1696;ERNESTINA;RS;75;28;103;271.844.660.194.174.000;728.155.339.805.825.000
1992;GUAIMB“;SP;75;28;103;271.844.660.194.174.000;728.155.339.805.825.000
1794;FERVEDOURO;MG;150;56;206;271.844.660.194.174.000;728.155.339.805.825.000
378;AREN‡POLIS;GO;75;28;103;271.844.660.194.174.000;728.155.339.805.825.000
144;ALTO ALEGRE;SP;75;28;103;271.844.660.194.174.000;728.155.339.805.825.000
3027;MATO CASTELHANO;RS;75;28;103;271.844.660.194.174.000;728.155.339.805.825.000
4620;S«O BENTO DO NORTE;RN;75;28;103;271.844.660.194.174.000;728.155.339.805.825.000
5083;SILVEIRA MARTINS;RS;75;28;103;271.844.660.194.174.000;728.155.339.805.825.000
2915;MANOEL URBANO;AC;142;53;195;271.794.871.794.871.000;728.205.128.205.128.000
2925;MARA«;AM;284;106;390;271.794.871.794.871.000;728.205.128.205.128.000
2826;LUISBURGO;MG;134;50;184;271.739.130.434.782.000;728.260.869.565.217.000
59;µGUA LIMPA;GO;67;25;92;271.739.130.434.782.000;728.260.869.565.217.000
1542;DAVIN‡POLIS;GO;67;25;92;271.739.130.434.782.000;728.260.869.565.217.000
1198;CATOL∂NDIA;BA;67;25;92;271.739.130.434.782.000;728.260.869.565.217.000
1344;CONCEIÄ«O DO CANINDê;PI;67;25;92;271.739.130.434.782.000;728.260.869.565.217.000
1234;CERES;GO;193;72;265;271.698.113.207.547.000;728.301.886.792.452.000
11;ABELARDO LUZ;SC;126;47;173;271.676.300.578.034.000;728.323.699.421.965.000
2583;JEQUITIBµ;MG;126;47;173;271.676.300.578.034.000;728.323.699.421.965.000
2299;ITABELA;BA;244;91;335;271.641.791.044.776.000;728.358.208.955.223.000
2518;JAGUARUNA;SC;118;44;162;271.604.938.271.604.000;728.395.061.728.395.000
3201;MORRO AGUDO;SP;236;88;324;271.604.938.271.604.000;728.395.061.728.395.000
4513;SANTA TEREZINHA;SC;118;44;162;271.604.938.271.604.000;728.395.061.728.395.000
4509;SANTA TEREZA;RS;59;22;81;271.604.938.271.604.000;728.395.061.728.395.000
103;ALECRIM;RS;59;22;81;271.604.938.271.604.000;728.395.061.728.395.000
590;BELêM DO PIAU÷;PI;59;22;81;271.604.938.271.604.000;728.395.061.728.395.000
4664;S«O FêLIX DO PIAU÷;PI;59;22;81;271.604.938.271.604.000;728.395.061.728.395.000
1014;CANµPOLIS;MG;169;63;232;271.551.724.137.931.000;728.448.275.862.068.000
807;BURITI ALEGRE;GO;110;41;151;271.523.178.807.947.000;728.476.821.192.052.000
5592;XAMBIOµ;TO;161;60;221;271.493.212.669.683.000;728.506.787.330.316.000
93;ALAGOINHA DO PIAU÷;PI;51;19;70;271.428.571.428.571.000;728.571.428.571.428.000
3678;PAU BRASIL;BA;102;38;140;271.428.571.428.571.000;728.571.428.571.428.000
1332;COMODORO;MT;196;73;269;271.375.464.684.014.000;728.624.535.315.985.000
1850;FOZ DO IGUAÄU;PR;537;200;737;271.370.420.624.151.000;728.629.579.375.848.000
3018;MATHIAS LOBATO;MG;145;54;199;271.356.783.919.597.000;728.643.216.080.402.000
1246;CêU AZUL;PR;94;35;129;271.317.829.457.364.000;728.682.170.542.635.000
724;BON‡POLIS;GO;94;35;129;271.317.829.457.364.000;728.682.170.542.635.000
1938;GOI∂NIA;GO;1558;580;2138;271.281.571.562.207.000;728.718.428.437.792.000
780;BREJO GRANDE;SE;137;51;188;271.276.595.744.680.000;728.723.404.255.319.000
4922;S«O SEBASTI«O DA GRAMA;SP;180;67;247;271.255.060.728.744.000;728.744.939.271.255.000
5551;VILA VELHA;ES;782;291;1073;271.202.236.719.478.000;728.797.763.280.521.000
968;CAMPO BELO DO SUL;SC;86;32;118;271.186.440.677.966.000;728.813.559.322.033.000
1386;CORAÄ«O DE JESUS;MG;301;112;413;271.186.440.677.966.000;728.813.559.322.033.000
3224;MUÄUM;RS;86;32;118;271.186.440.677.966.000;728.813.559.322.033.000
3669;PATO BRANCO;PR;215;80;295;271.186.440.677.966.000;728.813.559.322.033.000
3954;PONTO CHIQUE;MG;86;32;118;271.186.440.677.966.000;728.813.559.322.033.000
4372;SANHAR‡;PE;129;48;177;271.186.440.677.966.000;728.813.559.322.033.000
4242;RIO DOS CEDROS;SC;86;32;118;271.186.440.677.966.000;728.813.559.322.033.000
5511;VEREDA;BA;86;32;118;271.186.440.677.966.000;728.813.559.322.033.000
4831;S«O JOSê DOS RAMOS;PB;86;32;118;271.186.440.677.966.000;728.813.559.322.033.000
4840;S«O LUDGERO;SC;86;32;118;271.186.440.677.966.000;728.813.559.322.033.000
4636;S«O CAITANO;PE;285;106;391;271.099.744.245.524.000;728.900.255.754.475.000
3232;MUNDO NOVO;GO;121;45;166;271.084.337.349.397.000;728.915.662.650.602.000
4969;SARANDI;RS;121;45;166;271.084.337.349.397.000;728.915.662.650.602.000
1248;CH« DE ALEGRIA;PE;199;74;273;271.062.271.062.271.000;728.937.728.937.728.000
445;AVELIN‡POLIS;GO;78;29;107;271.028.037.383.177.000;728.971.962.616.822.000
2393;ITAPIRA;SP;312;116;428;271.028.037.383.177.000;728.971.962.616.822.000
3610;PARAN«;TO;156;58;214;271.028.037.383.177.000;728.971.962.616.822.000
4916;S«O SALVADOR DO TOCANTINS;TO;78;29;107;271.028.037.383.177.000;728.971.962.616.822.000
3376;NOVA OLINDA DO NORTE;AM;304;113;417;270.983.213.429.256.000;729.016.786.570.743.000
2343;ITAJU DO COL‚NIA;BA;113;42;155;270.967.741.935.483.000;729.032.258.064.516.000
2716;LAGOA DOURADA;MG;113;42;155;270.967.741.935.483.000;729.032.258.064.516.000
3408;NOVA VIÄOSA;BA;296;110;406;270.935.960.591.133.000;729.064.039.408.866.000
3114;MIRASSOL;SP;296;110;406;270.935.960.591.133.000;729.064.039.408.866.000
4021;PRADO;BA;296;110;406;270.935.960.591.133.000;729.064.039.408.866.000
1977;GR«O MOGOL;MG;183;68;251;270.916.334.661.354.000;729.083.665.338.645.000
5411;UNA÷;MG;393;146;539;270.871.985.157.699.000;729.128.014.842.300.000
1900;GARRUCHOS;RS;70;26;96;270.833.333.333.333.000;729.166.666.666.666.000
1489;CRUZEIRO DA FORTALEZA;MG;105;39;144;270.833.333.333.333.000;729.166.666.666.666.000
296;ARAÄA÷;MG;105;39;144;270.833.333.333.333.000;729.166.666.666.666.000
250;ANHUMAS;SP;105;39;144;270.833.333.333.333.000;729.166.666.666.666.000
848;CACHOEIRA DE GOIµS;GO;70;26;96;270.833.333.333.333.000;729.166.666.666.666.000
4256;RIO NEGRO;MS;70;26;96;270.833.333.333.333.000;729.166.666.666.666.000
4542;SANTANA DO MANHUAÄU;MG;140;52;192;270.833.333.333.333.000;729.166.666.666.666.000
3665;PASSOS MAIA;SC;70;26;96;270.833.333.333.333.000;729.166.666.666.666.000
3429;NOVO LINO;AL;140;52;192;270.833.333.333.333.000;729.166.666.666.666.000
3431;NOVO MUNDO;MT;105;39;144;270.833.333.333.333.000;729.166.666.666.666.000
3985;PORTO ESPERIDI«O;MT;140;52;192;270.833.333.333.333.000;729.166.666.666.666.000
3791;PIACATU;SP;105;39;144;270.833.333.333.333.000;729.166.666.666.666.000
5297;TOROPI;RS;70;26;96;270.833.333.333.333.000;729.166.666.666.666.000
4786;S«O JOSê DE CAIANA;PB;70;26;96;270.833.333.333.333.000;729.166.666.666.666.000
3921;POÄO VERDE;SE;132;49;181;270.718.232.044.198.000;729.281.767.955.801.000
1151;CARNEIRINHO;MG;132;49;181;270.718.232.044.198.000;729.281.767.955.801.000
1975;GRANJA;CE;132;49;181;270.718.232.044.198.000;729.281.767.955.801.000
1765;FAZENDA NOVA;GO;97;36;133;270.676.691.729.323.000;729.323.308.270.676.000
1161;CARVALH‡POLIS;MG;97;36;133;270.676.691.729.323.000;729.323.308.270.676.000
752;BRµS PIRES;MG;97;36;133;270.676.691.729.323.000;729.323.308.270.676.000
2129;IBIRATAIA;BA;221;82;303;270.627.062.706.270.000;729.372.937.293.729.000
4604;SANTO ESTEV«O;BA;283;105;388;270.618.556.701.030.000;729.381.443.298.969.000
4316;RUBIµCEA;SP;124;46;170;270.588.235.294.117.000;729.411.764.705.882.000
5090;SIMÂES;PI;62;23;85;270.588.235.294.117.000;729.411.764.705.882.000
5318;TR“S COROAS;RS;124;46;170;270.588.235.294.117.000;729.411.764.705.882.000
3806;PIL«O ARCADO;BA;151;56;207;270.531.400.966.183.000;729.468.599.033.816.000
147;ALTO ALEGRE DOS PARECIS;RO;151;56;207;270.531.400.966.183.000;729.468.599.033.816.000
1318;COLNIZA;MT;240;89;329;270.516.717.325.227.000;729.483.282.674.772.000
1844;FORTALEZA DO TABOC«O;TO;89;33;122;270.491.803.278.688.000;729.508.196.721.311.000
541;BARRAC«O;PR;89;33;122;270.491.803.278.688.000;729.508.196.721.311.000
4349;SALOµ;PE;89;33;122;270.491.803.278.688.000;729.508.196.721.311.000
4488;SANTA RITA DO ITUETO;MG;89;33;122;270.491.803.278.688.000;729.508.196.721.311.000
2623;JOSê BOITEUX;SC;89;33;122;270.491.803.278.688.000;729.508.196.721.311.000
4814;S«O JOSê DO PEIXE;PI;89;33;122;270.491.803.278.688.000;729.508.196.721.311.000
2889;MALLET;PR;232;86;318;270.440.251.572.327.000;729.559.748.427.672.000
3508;OURO VERDE DE GOIµS;GO;116;43;159;270.440.251.572.327.000;729.559.748.427.672.000
1112;CARAZINHO;RS;232;86;318;270.440.251.572.327.000;729.559.748.427.672.000
1494;CRUZEIRO DO SUL;PR;116;43;159;270.440.251.572.327.000;729.559.748.427.672.000
544;BARREIRA;CE;143;53;196;270.408.163.265.306.000;729.591.836.734.693.000
2780;LEOPOLDO DE BULHÂES;GO;143;53;196;270.408.163.265.306.000;729.591.836.734.693.000
2814;LUCAS DO RIO VERDE;MT;143;53;196;270.408.163.265.306.000;729.591.836.734.693.000
5444;URUP“S;SP;143;53;196;270.408.163.265.306.000;729.591.836.734.693.000
3684;PAUINI;AM;170;63;233;270.386.266.094.420.000;729.613.733.905.579.000
1417;CORONEL PACHECO;MG;170;63;233;270.386.266.094.420.000;729.613.733.905.579.000
2177;IJU÷;RS;197;73;270;270.370.370.370.370.000;729.629.629.629.629.000
593;BELMONTE;BA;224;83;307;270.358.306.188.925.000;729.641.693.811.074.000
55;µGUA DOCE DO MARANH«O;MA;162;60;222;270.270.270.270.270.000;729.729.729.729.729.000
1892;GAMELEIRAS;MG;54;20;74;270.270.270.270.270.000;729.729.729.729.729.000
3491;OTAC÷LIO COSTA;SC;135;50;185;270.270.270.270.270.000;729.729.729.729.729.000
4434;SANTA IN“S;PB;54;20;74;270.270.270.270.270.000;729.729.729.729.729.000
3417;NOVO CABRAIS;RS;81;30;111;270.270.270.270.270.000;729.729.729.729.729.000
3347;NOVA GUATAPORANGA;SP;81;30;111;270.270.270.270.270.000;729.729.729.729.729.000
5408;UMIRIM;CE;135;50;185;270.270.270.270.270.000;729.729.729.729.729.000
4932;S«O SEBASTI«O DO RIO PRETO;MG;81;30;111;270.270.270.270.270.000;729.729.729.729.729.000
3278;NER‡POLIS;GO;262;97;359;270.194.986.072.423.000;729.805.013.927.576.000
82;AIMORêS;MG;208;77;285;270.175.438.596.491.000;729.824.561.403.508.000
178;ALVIN‡POLIS;MG;208;77;285;270.175.438.596.491.000;729.824.561.403.508.000
2606;JO«O LISBOA;MA;181;67;248;270.161.290.322.580.000;729.838.709.677.419.000
4705;S«O GONÄALO DO RIO ABAIXO;MG;181;67;248;270.161.290.322.580.000;729.838.709.677.419.000
5550;VILA VALêRIO;ES;181;67;248;270.161.290.322.580.000;729.838.709.677.419.000
385;ARIRANHA;SP;127;47;174;270.114.942.528.735.000;729.885.057.471.264.000
1868;FREDERICO WESTPHALEN;RS;100;37;137;270.072.992.700.729.000;729.927.007.299.270.000
1730;ESTRELA DE ALAGOAS;AL;100;37;137;270.072.992.700.729.000;729.927.007.299.270.000
2203;INDAIABIRA;MG;100;37;137;270.072.992.700.729.000;729.927.007.299.270.000
2587;JERIQUARA;SP;73;27;100;270.000.000.000.000.000;730.000.000.000.000.000
2852;MACAÈBAS;BA;146;54;200;270.000.000.000.000.000;730.000.000.000.000.000
4350;SALTINHO;SP;146;54;200;270.000.000.000.000.000;730.000.000.000.000.000
3700;PAULO LOPES;SC;73;27;100;270.000.000.000.000.000;730.000.000.000.000.000
4584;SANTO ANT‚NIO DO GRAMA;MG;146;54;200;270.000.000.000.000.000;730.000.000.000.000.000
4920;S«O SEBASTI«O DA BELA VISTA;MG;119;44;163;269.938.650.306.748.000;730.061.349.693.251.000
3433;NOVO ORIENTE DE MINAS;MG;165;61;226;269.911.504.424.778.000;730.088.495.575.221.000
4812;S«O JOSê DO NORTE;RS;165;61;226;269.911.504.424.778.000;730.088.495.575.221.000
3461;OLHOS D'µGUA;MG;138;51;189;269.841.269.841.269.000;730.158.730.158.730.000
1578;DIVINêSIA;MG;92;34;126;269.841.269.841.269.000;730.158.730.158.730.000
411;ASSARê;CE;138;51;189;269.841.269.841.269.000;730.158.730.158.730.000
269;ANT‚NIO PRADO;RS;92;34;126;269.841.269.841.269.000;730.158.730.158.730.000
629;BILAC;SP;92;34;126;269.841.269.841.269.000;730.158.730.158.730.000
617;BERNARDO SAY«O;TO;92;34;126;269.841.269.841.269.000;730.158.730.158.730.000
5061;SERROL∂NDIA;BA;92;34;126;269.841.269.841.269.000;730.158.730.158.730.000
3835;PINH«O;PR;203;75;278;269.784.172.661.870.000;730.215.827.338.129.000
3358;NOVA LARANJEIRAS;PR;111;41;152;269.736.842.105.263.000;730.263.157.894.736.000
1461;CRISSIUMAL;RS;111;41;152;269.736.842.105.263.000;730.263.157.894.736.000
4789;S«O JOSê DE PIRANHAS;PB;111;41;152;269.736.842.105.263.000;730.263.157.894.736.000
4662;S«O FêLIX DO ARAGUAIA;MT;111;41;152;269.736.842.105.263.000;730.263.157.894.736.000
5442;URUPµ;RO;176;65;241;269.709.543.568.464.000;730.290.456.431.535.000
5162;TAIOBEIRAS;MG;176;65;241;269.709.543.568.464.000;730.290.456.431.535.000
1271;CHIAPETTA;RS;65;24;89;269.662.921.348.314.000;730.337.078.651.685.000
1252;CHALê;MG;65;24;89;269.662.921.348.314.000;730.337.078.651.685.000
594;BELMONTE;SC;65;24;89;269.662.921.348.314.000;730.337.078.651.685.000
518;BARRA DE S«O FRANCISCO;ES;260;96;356;269.662.921.348.314.000;730.337.078.651.685.000
3071;MESSIAS TARGINO;RN;65;24;89;269.662.921.348.314.000;730.337.078.651.685.000
2331;ITAIN‡POLIS;PI;65;24;89;269.662.921.348.314.000;730.337.078.651.685.000
2530;JANDU÷S;RN;65;24;89;269.662.921.348.314.000;730.337.078.651.685.000
5167;TAMANDARê;PE;214;79;293;269.624.573.378.839.000;730.375.426.621.160.000
146;ALTO ALEGRE DO PINDARê;MA;187;69;256;269.531.250.000.000.000;730.468.750.000.000.000
1090;CAPIXABA;AC;187;69;256;269.531.250.000.000.000;730.468.750.000.000.000
514;BARRA DE GUABIRABA;PE;122;45;167;269.461.077.844.311.000;730.538.922.155.688.000
3009;MATA GRANDE;AL;122;45;167;269.461.077.844.311.000;730.538.922.155.688.000
4525;SANTANA;BA;122;45;167;269.461.077.844.311.000;730.538.922.155.688.000
4066;PRIMEIRA CRUZ;MA;141;52;193;269.430.051.813.471.000;730.569.948.186.528.000
1540;DATAS;MG;141;52;193;269.430.051.813.471.000;730.569.948.186.528.000
3575;PANAMBI;RS;160;59;219;269.406.392.694.063.000;730.593.607.305.936.000
5226;TEIXEIRAS;MG;160;59;219;269.406.392.694.063.000;730.593.607.305.936.000
525;BARRA DO GARÄAS;MT;293;108;401;269.326.683.291.770.000;730.673.316.708.229.000
916;CALDEIR«O GRANDE DO PIAU÷;PI;57;21;78;269.230.769.230.769.000;730.769.230.769.230.000
1580;DIVINO DAS LARANJEIRAS;MG;95;35;130;269.230.769.230.769.000;730.769.230.769.230.000
1411;CORONEL JO«O PESSOA;RN;38;14;52;269.230.769.230.769.000;730.769.230.769.230.000
2140;ICAPU÷;CE;114;42;156;269.230.769.230.769.000;730.769.230.769.230.000
2251;IPIRANGA DO SUL;RS;57;21;78;269.230.769.230.769.000;730.769.230.769.230.000
4122;RAFAEL GODEIRO;RN;57;21;78;269.230.769.230.769.000;730.769.230.769.230.000
3037;MATOS COSTA;SC;76;28;104;269.230.769.230.769.000;730.769.230.769.230.000
5249;TERRA BOA;PR;76;28;104;269.230.769.230.769.000;730.769.230.769.230.000
5467;VARGEM ALEGRE;MG;133;49;182;269.230.769.230.769.000;730.769.230.769.230.000
4991;SEGREDO;RS;76;28;104;269.230.769.230.769.000;730.769.230.769.230.000
1150;CARNAUBEIRA DA PENHA;PE;144;53;197;269.035.532.994.923.000;730.964.467.005.076.000
226;ANAURIL∂NDIA;MS;125;46;171;269.005.847.953.216.000;730.994.152.046.783.000
2353;ITAMBACURI;MG;250;92;342;269.005.847.953.216.000;730.994.152.046.783.000
4253;RIO MANSO;MG;125;46;171;269.005.847.953.216.000;730.994.152.046.783.000
4755;S«O JO«O DO RIO DO PEIXE;PB;125;46;171;269.005.847.953.216.000;730.994.152.046.783.000
3515;PACAJµ;PA;212;78;290;268.965.517.241.379.000;731.034.482.758.620.000
932;CAMBê;PR;318;117;435;268.965.517.241.379.000;731.034.482.758.620.000
781;BREJO GRANDE DO ARAGUAIA;PA;106;39;145;268.965.517.241.379.000;731.034.482.758.620.000
1982;GROA÷RAS;CE;106;39;145;268.965.517.241.379.000;731.034.482.758.620.000
1916;GENTIO DO OURO;BA;87;32;119;268.907.563.025.210.000;731.092.436.974.789.000
1715;ESP÷RITO SANTO;RN;87;32;119;268.907.563.025.210.000;731.092.436.974.789.000
2248;IPIRANGA DE GOIµS;GO;87;32;119;268.907.563.025.210.000;731.092.436.974.789.000
2077;HON‡RIO SERPA;PR;87;32;119;268.907.563.025.210.000;731.092.436.974.789.000
5454;VALE VERDE;RS;87;32;119;268.907.563.025.210.000;731.092.436.974.789.000
5025;SEROPêDICA;RJ;416;153;569;268.892.794.376.098.000;731.107.205.623.901.000
1763;FAXINAL DOS GUEDES;SC;68;25;93;268.817.204.301.075.000;731.182.795.698.924.000
1872;FREI MARTINHO;PB;68;25;93;268.817.204.301.075.000;731.182.795.698.924.000
1317;COLMêIA;TO;136;50;186;268.817.204.301.075.000;731.182.795.698.924.000
770;BREJINHO;PE;68;25;93;268.817.204.301.075.000;731.182.795.698.924.000
3522;PACUJµ;CE;68;25;93;268.817.204.301.075.000;731.182.795.698.924.000
3583;PAQUETµ;PI;68;25;93;268.817.204.301.075.000;731.182.795.698.924.000
2477;JABORµ;SC;68;25;93;268.817.204.301.075.000;731.182.795.698.924.000
3078;MILAGRES;CE;68;25;93;268.817.204.301.075.000;731.182.795.698.924.000
675;BOM JARDIM;RJ;215;79;294;268.707.482.993.197.000;731.292.517.006.802.000
227;ANCHIETA;ES;245;90;335;268.656.716.417.910.000;731.343.283.582.089.000
84;AIUABA;CE;98;36;134;268.656.716.417.910.000;731.343.283.582.089.000
3070;MESSIAS;AL;196;72;268;268.656.716.417.910.000;731.343.283.582.089.000
2478;JABORANDI;SP;98;36;134;268.656.716.417.910.000;731.343.283.582.089.000
2462;ITUPORANGA;SC;98;36;134;268.656.716.417.910.000;731.343.283.582.089.000
2559;JARDIN‡POLIS;SC;49;18;67;268.656.716.417.910.000;731.343.283.582.089.000
4314;ROTEIRO;AL;98;36;134;268.656.716.417.910.000;731.343.283.582.089.000
4375;SANTA AMêLIA;PR;98;36;134;268.656.716.417.910.000;731.343.283.582.089.000
4579;SANTO ANT‚NIO DO AMPARO;MG;245;90;335;268.656.716.417.910.000;731.343.283.582.089.000
5185;TAPEJARA;RS;98;36;134;268.656.716.417.910.000;731.343.283.582.089.000
597;BELO JARDIM;PE;226;83;309;268.608.414.239.482.000;731.391.585.760.517.000
5047;SERRA TALHADA;PE;226;83;309;268.608.414.239.482.000;731.391.585.760.517.000
911;CALDAS;MG;128;47;175;268.571.428.571.428.000;731.428.571.428.571.000
3863;PIRANGA;MG;158;58;216;268.518.518.518.518.000;731.481.481.481.481.000
4760;S«O JO«O DO TRIUNFO;PR;188;69;257;268.482.490.272.373.000;731.517.509.727.626.000
12;ABRE CAMPO;MG;109;40;149;268.456.375.838.926.000;731.543.624.161.073.000
635;BLUMENAU;SC;466;171;637;268.445.839.874.411.000;731.554.160.125.588.000
1107;CARAUARI;AM;139;51;190;268.421.052.631.578.000;731.578.947.368.421.000
694;BOM JESUS DO OESTE;SC;60;22;82;268.292.682.926.829.000;731.707.317.073.170.000
466;BALBINOS;SP;60;22;82;268.292.682.926.829.000;731.707.317.073.170.000
377;ARENµPOLIS;MT;150;55;205;268.292.682.926.829.000;731.707.317.073.170.000
1420;CORONEL VIVIDA;PR;90;33;123;268.292.682.926.829.000;731.707.317.073.170.000
1158;CARRASCO BONITO;TO;90;33;123;268.292.682.926.829.000;731.707.317.073.170.000
1179;CASTANHEIRA;MT;120;44;164;268.292.682.926.829.000;731.707.317.073.170.000
3032;MATO QUEIMADO;RS;30;11;41;268.292.682.926.829.000;731.707.317.073.170.000
5154;TACIBA;SP;90;33;123;268.292.682.926.829.000;731.707.317.073.170.000
5443;URUPEMA;SC;60;22;82;268.292.682.926.829.000;731.707.317.073.170.000
196;AMARGOSA;BA;251;92;343;268.221.574.344.023.000;731.778.425.655.976.000
1863;FRANCISCO Sµ;MG;221;81;302;268.211.920.529.801.000;731.788.079.470.198.000
27;ACREL∂NDIA;AC;191;70;261;268.199.233.716.475.000;731.800.766.283.524.000
3955;PONTO DOS VOLANTES;MG;161;59;220;268.181.818.181.818.000;731.818.181.818.181.000
3789;PETR‡POLIS;RJ;644;236;880;268.181.818.181.818.000;731.818.181.818.181.000
2978;MARILENA;PR;131;48;179;268.156.424.581.005.000;731.843.575.418.994.000
1141;CARMO DO RIO CLARO;MG;232;85;317;268.138.801.261.829.000;731.861.198.738.170.000
33;ADRIAN‡POLIS;PR;101;37;138;268.115.942.028.985.000;731.884.057.971.014.000
4517;SANTA TEREZINHA DE GOIµS;GO;101;37;138;268.115.942.028.985.000;731.884.057.971.014.000
4505;SANTA ROSA DO TOCANTINS;TO;101;37;138;268.115.942.028.985.000;731.884.057.971.014.000
5024;SERITINGA;MG;101;37;138;268.115.942.028.985.000;731.884.057.971.014.000
3553;PALMEIRA;SC;71;26;97;268.041.237.113.402.000;731.958.762.886.597.000
1835;FORMOSA DO SUL;SC;71;26;97;268.041.237.113.402.000;731.958.762.886.597.000
5595;XANXER“;SC;142;52;194;268.041.237.113.402.000;731.958.762.886.597.000
3943;PONTE ALTA;SC;112;41;153;267.973.856.209.150.000;732.026.143.790.849.000
4098;QUEIROZ;SP;112;41;153;267.973.856.209.150.000;732.026.143.790.849.000
2783;LIBERDADE;MG;112;41;153;267.973.856.209.150.000;732.026.143.790.849.000
3896;PIUMHI;MG;235;86;321;267.912.772.585.669.000;732.087.227.414.330.000
4370;SANDOVALINA;SP;164;60;224;267.857.142.857.142.000;732.142.857.142.857.000
2884;MALACACHETA;MG;205;75;280;267.857.142.857.142.000;732.142.857.142.857.000
3192;MOREIL∂NDIA;PE;82;30;112;267.857.142.857.142.000;732.142.857.142.857.000
182;ALVORADA DO GURGUêIA;PI;82;30;112;267.857.142.857.142.000;732.142.857.142.857.000
436;AURORA;CE;82;30;112;267.857.142.857.142.000;732.142.857.142.857.000
567;BATATAIS;SP;328;120;448;267.857.142.857.142.000;732.142.857.142.857.000
704;BOM RETIRO;SC;82;30;112;267.857.142.857.142.000;732.142.857.142.857.000
787;BRIT∂NIA;GO;123;45;168;267.857.142.857.142.000;732.142.857.142.857.000
4809;S«O JOSê DO JACU÷PE;BA;82;30;112;267.857.142.857.142.000;732.142.857.142.857.000
2744;LAJES;RN;134;49;183;267.759.562.841.530.000;732.240.437.158.469.000
768;BREJ«O;PE;93;34;127;267.716.535.433.070.000;732.283.464.566.929.000
552;BARRO;CE;93;34;127;267.716.535.433.070.000;732.283.464.566.929.000
2280;IRAPU«;SP;93;34;127;267.716.535.433.070.000;732.283.464.566.929.000
1368;CONGONHAL;MG;93;34;127;267.716.535.433.070.000;732.283.464.566.929.000
4699;S«O GONÄALO DO ABAETê;MG;93;34;127;267.716.535.433.070.000;732.283.464.566.929.000
330;ARANDU;SP;145;53;198;267.676.767.676.767.000;732.323.232.323.232.000
2045;GUARIBAS;PI;52;19;71;267.605.633.802.816.000;732.394.366.197.183.000
1817;FLORESTA DO ARAGUAIA;PA;208;76;284;267.605.633.802.816.000;732.394.366.197.183.000
1743;EWBANK DA C∂MARA;MG;156;57;213;267.605.633.802.816.000;732.394.366.197.183.000
1973;GRANDES RIOS;PR;104;38;142;267.605.633.802.816.000;732.394.366.197.183.000
2571;JATOBµ DO PIAU÷;PI;104;38;142;267.605.633.802.816.000;732.394.366.197.183.000
2591;JESU÷TAS;PR;104;38;142;267.605.633.802.816.000;732.394.366.197.183.000
3796;PICADA CAFê;RS;104;38;142;267.605.633.802.816.000;732.394.366.197.183.000
5374;TURV∂NIA;GO;104;38;142;267.605.633.802.816.000;732.394.366.197.183.000
4067;PRIMEIRO DE MAIO;PR;115;42;157;267.515.923.566.878.000;732.484.076.433.121.000
4492;SANTA RITA DO SAPUCA÷;MG;293;107;400;267.500.000.000.000.000;732.500.000.000.000.000
3280;NHAMUNDµ;AM;178;65;243;267.489.711.934.156.000;732.510.288.065.843.000
2582;JEQUITA÷;MG;126;46;172;267.441.860.465.116.000;732.558.139.534.883.000
2487;JACARê DOS HOMENS;AL;63;23;86;267.441.860.465.116.000;732.558.139.534.883.000
4558;SANTIAGO DO SUL;SC;63;23;86;267.441.860.465.116.000;732.558.139.534.883.000
4159;RESSAQUINHA;MG;126;46;172;267.441.860.465.116.000;732.558.139.534.883.000
526;BARRA DO GUARITA;RS;63;23;86;267.441.860.465.116.000;732.558.139.534.883.000
47;µGUA BOA;MG;189;69;258;267.441.860.465.116.000;732.558.139.534.883.000
4600;SANTO ANT‚NIO DOS LOPES;MA;126;46;172;267.441.860.465.116.000;732.558.139.534.883.000
4832;S«O JULI«O;PI;63;23;86;267.441.860.465.116.000;732.558.139.534.883.000
1088;CAPIVARI DE BAIXO;SC;222;81;303;267.326.732.673.267.000;732.673.267.326.732.000
867;CACIMBINHAS;AL;74;27;101;267.326.732.673.267.000;732.673.267.326.732.000
2986;MARIPµ DE MINAS;MG;74;27;101;267.326.732.673.267.000;732.673.267.326.732.000
3061;MENDES PIMENTEL;MG;74;27;101;267.326.732.673.267.000;732.673.267.326.732.000
2552;JARDIM;MS;159;58;217;267.281.105.990.783.000;732.718.894.009.216.000
3125;MOEDA;MG;170;62;232;267.241.379.310.344.000;732.758.620.689.655.000
4170;RIACHINHO;MG;85;31;116;267.241.379.310.344.000;732.758.620.689.655.000
1919;GILBUêS;PI;85;31;116;267.241.379.310.344.000;732.758.620.689.655.000
666;BOD‡;RN;96;35;131;267.175.572.519.083.000;732.824.427.480.916.000
1303;CODAJµS;AM;203;74;277;267.148.014.440.433.000;732.851.985.559.566.000
212;AMPêRE;PR;107;39;146;267.123.287.671.232.000;732.876.712.328.767.000
5187;TAPERA;RS;107;39;146;267.123.287.671.232.000;732.876.712.328.767.000
306;ARAÄOIABA;PE;225;82;307;267.100.977.198.697.000;732.899.022.801.302.000
1922;GLAUCIL∂NDIA;MG;118;43;161;267.080.745.341.614.000;732.919.254.658.385.000
1981;GRAVATAL;SC;118;43;161;267.080.745.341.614.000;732.919.254.658.385.000
3171;MONTE FORMOSO;MG;118;43;161;267.080.745.341.614.000;732.919.254.658.385.000
5378;TURVOL∂NDIA;MG;118;43;161;267.080.745.341.614.000;732.919.254.658.385.000
938;CAMETµ;PA;376;137;513;267.056.530.214.424.000;732.943.469.785.575.000
2316;ITAETê;BA;129;47;176;267.045.454.545.454.000;732.954.545.454.545.000
3126;MOEMA;MG;140;51;191;267.015.706.806.282.000;732.984.293.193.717.000
4943;S«O TOMê;PR;151;55;206;266.990.291.262.135.000;733.009.708.737.864.000
1491;CRUZEIRO DO OESTE;PR;217;79;296;266.891.891.891.891.000;733.108.108.108.108.000
1442;COSTA MARQUES;RO;154;56;210;266.666.666.666.666.000;733.333.333.333.333.000
1593;DOIS IRM«OS DAS MISSÂES;RS;66;24;90;266.666.666.666.666.000;733.333.333.333.333.000
1314;COLINAS;RS;77;28;105;266.666.666.666.666.000;733.333.333.333.333.000
1779;FELIZ;RS;110;40;150;266.666.666.666.666.000;733.333.333.333.333.000
2149;IELMO MARINHO;RN;132;48;180;266.666.666.666.666.000;733.333.333.333.333.000
1077;CAPINZAL DO NORTE;MA;88;32;120;266.666.666.666.666.000;733.333.333.333.333.000
654;BOA VISTA DO INCRA;RS;77;28;105;266.666.666.666.666.000;733.333.333.333.333.000
690;BOM JESUS DO ARAGUAIA;MT;143;52;195;266.666.666.666.666.000;733.333.333.333.333.000
613;BERIZAL;MG;110;40;150;266.666.666.666.666.000;733.333.333.333.333.000
855;CACHOEIRA DOURADA;MG;77;28;105;266.666.666.666.666.000;733.333.333.333.333.000
3226;MUCURICI;ES;99;36;135;266.666.666.666.666.000;733.333.333.333.333.000
3416;NOVO BRASIL;GO;66;24;90;266.666.666.666.666.000;733.333.333.333.333.000
2741;LAJEDINHO;BA;66;24;90;266.666.666.666.666.000;733.333.333.333.333.000
2778;LEOBERTO LEAL;SC;66;24;90;266.666.666.666.666.000;733.333.333.333.333.000
2747;LAMAR«O;BA;88;32;120;266.666.666.666.666.000;733.333.333.333.333.000
2839;LUZIN‡POLIS;TO;66;24;90;266.666.666.666.666.000;733.333.333.333.333.000
2808;LONTRA;MG;121;44;165;266.666.666.666.666.000;733.333.333.333.333.000
3857;PIRA÷ DO NORTE;BA;99;36;135;266.666.666.666.666.000;733.333.333.333.333.000
3967;PORTEIRINHA;MG;198;72;270;266.666.666.666.666.000;733.333.333.333.333.000
3494;OURICURI;PE;330;120;450;266.666.666.666.666.000;733.333.333.333.333.000
4908;S«O RAIMUNDO DAS MANGABEIRAS;MA;143;52;195;266.666.666.666.666.000;733.333.333.333.333.000
4985;SEBASTIAN‡POLIS DO SUL;SP;66;24;90;266.666.666.666.666.000;733.333.333.333.333.000
5156;TACURU;MS;176;64;240;266.666.666.666.666.000;733.333.333.333.333.000
4843;S«O LU÷S DO CURU;CE;165;60;225;266.666.666.666.666.000;733.333.333.333.333.000
4849;S«O LUIZ DO NORTE;GO;88;32;120;266.666.666.666.666.000;733.333.333.333.333.000
4803;S«O JOSê DO DIVINO;MG;77;28;105;266.666.666.666.666.000;733.333.333.333.333.000
2564;JATA÷;GO;278;101;379;266.490.765.171.503.000;733.509.234.828.496.000
5414;UNI«O DA VIT‡RIA;PR;267;97;364;266.483.516.483.516.000;733.516.483.516.483.000
57;µGUA FRIA;BA;168;61;229;266.375.545.851.528.000;733.624.454.148.471.000
4561;SANTO AMARO DA IMPERATRIZ;SC;157;57;214;266.355.140.186.915.000;733.644.859.813.084.000
4189;RIBEIRA DO POMBAL;BA;135;49;184;266.304.347.826.086.000;733.695.652.173.913.000
915;CALDEIR«O GRANDE;BA;135;49;184;266.304.347.826.086.000;733.695.652.173.913.000
2767;LAV÷NIA;SP;124;45;169;266.272.189.349.112.000;733.727.810.650.887.000
4714;S«O JO«O BATISTA;MA;237;86;323;266.253.869.969.040.000;733.746.130.030.959.000
2678;JUTA÷;AM;226;82;308;266.233.766.233.766.000;733.766.233.766.233.000
2443;ITAVERAVA;MG;113;41;154;266.233.766.233.766.000;733.766.233.766.233.000
396;ARROIO DO MEIO;RS;113;41;154;266.233.766.233.766.000;733.766.233.766.233.000
5446;URUTA÷;GO;113;41;154;266.233.766.233.766.000;733.766.233.766.233.000
5436;URUÄUCA;BA;215;78;293;266.211.604.095.563.000;733.788.395.904.436.000
1092;CAPUTIRA;MG;102;37;139;266.187.050.359.712.000;733.812.949.640.287.000
2139;IBOTIRAMA;BA;102;37;139;266.187.050.359.712.000;733.812.949.640.287.000
2074;HIDROL∂NDIA;CE;102;37;139;266.187.050.359.712.000;733.812.949.640.287.000
1950;GONZAGA;MG;102;37;139;266.187.050.359.712.000;733.812.949.640.287.000
4902;S«O PEDRO DO SUAÄU÷;MG;102;37;139;266.187.050.359.712.000;733.812.949.640.287.000
418;ASTOLFO DUTRA;MG;193;70;263;266.159.695.817.490.000;733.840.304.182.509.000
5268;TIJUCAS DO SUL;PR;193;70;263;266.159.695.817.490.000;733.840.304.182.509.000
85;AIURUOCA;MG;91;33;124;266.129.032.258.064.000;733.870.967.741.935.000
1008;CANA«;MG;91;33;124;266.129.032.258.064.000;733.870.967.741.935.000
3185;MONTES CLAROS DE GOIµS;GO;91;33;124;266.129.032.258.064.000;733.870.967.741.935.000
4163;RIACH«O;MA;182;66;248;266.129.032.258.064.000;733.870.967.741.935.000
4094;QUEIMADA NOVA;PI;80;29;109;266.055.045.871.559.000;733.944.954.128.440.000
3007;MATA;RS;80;29;109;266.055.045.871.559.000;733.944.954.128.440.000
2906;MANFRIN‡POLIS;PR;80;29;109;266.055.045.871.559.000;733.944.954.128.440.000
626;BIAS FORTES;MG;80;29;109;266.055.045.871.559.000;733.944.954.128.440.000
270;ANT‚NIO PRADO DE MINAS;MG;80;29;109;266.055.045.871.559.000;733.944.954.128.440.000
1719;ESPLANADA;BA;320;116;436;266.055.045.871.559.000;733.944.954.128.440.000
5235;TEN‡RIO;PB;80;29;109;266.055.045.871.559.000;733.944.954.128.440.000
5479;VARRE-SAI;RJ;160;58;218;266.055.045.871.559.000;733.944.954.128.440.000
4979;SAUDADE DO IGUAÄU;PR;80;29;109;266.055.045.871.559.000;733.944.954.128.440.000
2198;INµCIO MARTINS;PR;149;54;203;266.009.852.216.748.000;733.990.147.783.251.000
3360;NOVA LONDRINA;PR;149;54;203;266.009.852.216.748.000;733.990.147.783.251.000
2288;IRETAMA;PR;149;54;203;266.009.852.216.748.000;733.990.147.783.251.000
4149;REMANSO;BA;149;54;203;266.009.852.216.748.000;733.990.147.783.251.000
1279;CIANORTE;PR;218;79;297;265.993.265.993.265.000;734.006.734.006.734.000
1616;DOMINGOS MOUR«O;PI;69;25;94;265.957.446.808.510.000;734.042.553.191.489.000
2409;ITAPOROROCA;PB;69;25;94;265.957.446.808.510.000;734.042.553.191.489.000
3248;MUTU÷PE;BA;138;50;188;265.957.446.808.510.000;734.042.553.191.489.000
3101;MIRAGUA÷;RS;69;25;94;265.957.446.808.510.000;734.042.553.191.489.000
5324;TR“S PALMEIRAS;RS;69;25;94;265.957.446.808.510.000;734.042.553.191.489.000
1802;FIRMIN‡POLIS;GO;127;46;173;265.895.953.757.225.000;734.104.046.242.774.000
3240;MUQUI;ES;243;88;331;265.861.027.190.332.000;734.138.972.809.667.000
2738;LAJEADO GRANDE;SC;58;21;79;265.822.784.810.126.000;734.177.215.189.873.000
1829;FORMIGA;MG;290;105;395;265.822.784.810.126.000;734.177.215.189.873.000
902;CAJAZEIRAS DO PIAU÷;PI;58;21;79;265.822.784.810.126.000;734.177.215.189.873.000
929;CAMARGO;RS;58;21;79;265.822.784.810.126.000;734.177.215.189.873.000
5270;TIMBAÈBA DOS BATISTAS;RN;58;21;79;265.822.784.810.126.000;734.177.215.189.873.000
4674;S«O FRANCISCO DE ASSIS DO PIAU÷;PI;58;21;79;265.822.784.810.126.000;734.177.215.189.873.000
2461;ITUPIRANGA;PA;315;114;429;265.734.265.734.265.000;734.265.734.265.734.000
2642;JUCURUÄU;BA;152;55;207;265.700.483.091.787.000;734.299.516.908.212.000
725;BOQUEIR«O;PB;152;55;207;265.700.483.091.787.000;734.299.516.908.212.000
5279;TIRADENTES;MG;152;55;207;265.700.483.091.787.000;734.299.516.908.212.000
3450;OEIRAS DO PARµ;PA;199;72;271;265.682.656.826.568.000;734.317.343.173.431.000
4292;ROLIM DE MOURA;RO;246;89;335;265.671.641.791.044.000;734.328.358.208.955.000
2433;ITATIRA;CE;141;51;192;265.625.000.000.000.000;734.375.000.000.000.000
1700;ERVµLIA;MG;141;51;192;265.625.000.000.000.000;734.375.000.000.000.000
4634;S«O CAETANO DE ODIVELAS;PA;188;68;256;265.625.000.000.000.000;734.375.000.000.000.000
4865;S«O MIGUEL DAS MATAS;BA;130;47;177;265.536.723.163.841.000;734.463.276.836.158.000
1621;DORES DE CAMPOS;MG;83;30;113;265.486.725.663.716.000;734.513.274.336.283.000
1275;CHORROCH‡;BA;83;30;113;265.486.725.663.716.000;734.513.274.336.283.000
746;BRAÄO DO TROMBUDO;SC;83;30;113;265.486.725.663.716.000;734.513.274.336.283.000
3344;NOVA GL‡RIA;GO;83;30;113;265.486.725.663.716.000;734.513.274.336.283.000
4477;SANTA M‚NICA;PR;83;30;113;265.486.725.663.716.000;734.513.274.336.283.000
3448;OCAUÄU;SP;83;30;113;265.486.725.663.716.000;734.513.274.336.283.000
5169;TAMBAÈ;SP;249;90;339;265.486.725.663.716.000;734.513.274.336.283.000
3740;PEDRO CANµRIO;ES;285;103;388;265.463.917.525.773.000;734.536.082.474.226.000
523;BARRA DO CHOÄA;BA;202;73;275;265.454.545.454.545.000;734.545.454.545.454.000
58;µGUA FRIA DE GOIµS;GO;119;43;162;265.432.098.765.432.000;734.567.901.234.567.000
4478;SANTA QUITêRIA;CE;155;56;211;265.402.843.601.895.000;734.597.156.398.104.000
3281;NHANDEARA;SP;155;56;211;265.402.843.601.895.000;734.597.156.398.104.000
3022;MATINA;BA;72;26;98;265.306.122.448.979.000;734.693.877.551.020.000
2550;JARAMATAIA;AL;72;26;98;265.306.122.448.979.000;734.693.877.551.020.000
3905;PLANALTO;RS;72;26;98;265.306.122.448.979.000;734.693.877.551.020.000
738;BOSSOROCA;RS;72;26;98;265.306.122.448.979.000;734.693.877.551.020.000
1961;GOVERNADOR LUIZ ROCHA;MA;72;26;98;265.306.122.448.979.000;734.693.877.551.020.000
4702;S«O GONÄALO DO GURGUêIA;PI;72;26;98;265.306.122.448.979.000;734.693.877.551.020.000
4464;SANTA MARIA DAS BARREIRAS;PA;205;74;279;265.232.974.910.394.000;734.767.025.089.605.000
4344;SALINAS;MG;205;74;279;265.232.974.910.394.000;734.767.025.089.605.000
1599;DOLCIN‡POLIS;SP;97;35;132;265.151.515.151.515.000;734.848.484.848.484.000
620;BERT‡POLIS;MG;97;35;132;265.151.515.151.515.000;734.848.484.848.484.000
140;ALTINHO;PE;97;35;132;265.151.515.151.515.000;734.848.484.848.484.000
1168;CASCAVEL;CE;255;92;347;265.129.682.997.118.000;734.870.317.002.881.000
2034;GUARAPUAVA;PR;474;171;645;265.116.279.069.767.000;734.883.720.930.232.000
812;BURITI DOS MONTES;PI;61;22;83;265.060.240.963.855.000;734.939.759.036.144.000
4037;PRESIDENTE BERNARDES;SP;183;66;249;265.060.240.963.855.000;734.939.759.036.144.000
3963;PORTALEGRE;RN;61;22;83;265.060.240.963.855.000;734.939.759.036.144.000
2683;LACERD‡POLIS;SC;61;22;83;265.060.240.963.855.000;734.939.759.036.144.000
5464;VARGE«O;SC;61;22;83;265.060.240.963.855.000;734.939.759.036.144.000
2406;ITAPORANGA;SP;172;62;234;264.957.264.957.264.000;735.042.735.042.735.000
356;ARATIBA;RS;86;31;117;264.957.264.957.264.000;735.042.735.042.735.000
5483;VµRZEA BRANCA;PI;86;31;117;264.957.264.957.264.000;735.042.735.042.735.000
5234;TENENTE PORTELA;RS;86;31;117;264.957.264.957.264.000;735.042.735.042.735.000
2239;IPECAETµ;BA;161;58;219;264.840.182.648.401.000;735.159.817.351.598.000
1364;C‚NEGO MARINHO;MG;125;45;170;264.705.882.352.941.000;735.294.117.647.058.000
1418;CORONEL PILAR;RS;50;18;68;264.705.882.352.941.000;735.294.117.647.058.000
314;ARAGUACEMA;TO;150;54;204;264.705.882.352.941.000;735.294.117.647.058.000
765;BRAÈNAS;MG;125;45;170;264.705.882.352.941.000;735.294.117.647.058.000
976;CAMPO FLORIDO;MG;100;36;136;264.705.882.352.941.000;735.294.117.647.058.000
3971;PORTO ACRE;AC;225;81;306;264.705.882.352.941.000;735.294.117.647.058.000
3552;PALMEIRA;PR;200;72;272;264.705.882.352.941.000;735.294.117.647.058.000
5082;SILVAN‡POLIS;TO;100;36;136;264.705.882.352.941.000;735.294.117.647.058.000
775;BREJO DA MADRE DE DEUS;PE;139;50;189;264.550.264.550.264.000;735.449.735.449.735.000
1002;CAMPOS NOVOS;SC;114;41;155;264.516.129.032.258.000;735.483.870.967.741.000
3455;OLHO D'µGUA DAS CUNH«S;MA;114;41;155;264.516.129.032.258.000;735.483.870.967.741.000
4994;SEM PEIXE;MG;114;41;155;264.516.129.032.258.000;735.483.870.967.741.000
2528;JANDA÷RA;RN;89;32;121;264.462.809.917.355.000;735.537.190.082.644.000
1811;FLORES DA CUNHA;RS;153;55;208;264.423.076.923.076.000;735.576.923.076.923.000
3960;PORANGATU;GO;281;101;382;264.397.905.759.162.000;735.602.094.240.837.000
4297;RONDINHA;RS;64;23;87;264.367.816.091.954.000;735.632.183.908.045.000
2644;JU÷NA;MT;192;69;261;264.367.816.091.954.000;735.632.183.908.045.000
1856;FRANCISCO AYRES;PI;64;23;87;264.367.816.091.954.000;735.632.183.908.045.000
1875;FREI ROGêRIO;SC;64;23;87;264.367.816.091.954.000;735.632.183.908.045.000
2282;IRAQUARA;BA;192;69;261;264.367.816.091.954.000;735.632.183.908.045.000
1260;CHAPAD«O DO LAGEADO;SC;64;23;87;264.367.816.091.954.000;735.632.183.908.045.000
965;CAMPO ALEGRE DO FIDALGO;PI;64;23;87;264.367.816.091.954.000;735.632.183.908.045.000
4720;S«O JO«O DA CANABRAVA;PI;64;23;87;264.367.816.091.954.000;735.632.183.908.045.000
4856;S«O MARTINHO;RS;64;23;87;264.367.816.091.954.000;735.632.183.908.045.000
4759;S«O JO«O DO TIGRE;PB;64;23;87;264.367.816.091.954.000;735.632.183.908.045.000
3059;MELGAÄO;PA;167;60;227;264.317.180.616.740.000;735.682.819.383.259.000
1629;DOURADINA;PR;103;37;140;264.285.714.285.714.000;735.714.285.714.285.000
849;CACHOEIRA DE MINAS;MG;142;51;193;264.248.704.663.212.000;735.751.295.336.787.000
4140;REDENÄ«O DA SERRA;SP;142;51;193;264.248.704.663.212.000;735.751.295.336.787.000
5213;TARTARUGALZINHO;AP;181;65;246;264.227.642.276.422.000;735.772.357.723.577.000
2640;JUCµS;CE;78;28;106;264.150.943.396.226.000;735.849.056.603.773.000
2789;LIMEIRA DO OESTE;MG;117;42;159;264.150.943.396.226.000;735.849.056.603.773.000
1441;COSMORAMA;SP;78;28;106;264.150.943.396.226.000;735.849.056.603.773.000
1197;CATINGUEIRA;PB;78;28;106;264.150.943.396.226.000;735.849.056.603.773.000
5472;VARGEM GRANDE DO RIO PARDO;MG;78;28;106;264.150.943.396.226.000;735.849.056.603.773.000
4750;S«O JO«O DO PARA÷SO;MA;170;61;231;264.069.264.069.264.000;735.930.735.930.735.000
1979;GRAVATµ;PE;407;146;553;264.014.466.546.112.000;735.985.533.453.887.000
1475;CRIST‡POLIS;BA;92;33;125;264.000.000.000.000.000;736.000.000.000.000.000
472;BALNEµRIO GAIVOTA;SC;92;33;125;264.000.000.000.000.000;736.000.000.000.000.000
4548;SANTANA DO RIACHO;MG;145;52;197;263.959.390.862.944.000;736.040.609.137.055.000
3616;PARANAPANEMA;SP;145;52;197;263.959.390.862.944.000;736.040.609.137.055.000
3804;PIEDADE DOS GERAIS;MG;106;38;144;263.888.888.888.888.000;736.111.111.111.111.000
4003;PORTO VERA CRUZ;RS;53;19;72;263.888.888.888.888.000;736.111.111.111.111.000
3319;NOVA BOA VISTA;RS;53;19;72;263.888.888.888.888.000;736.111.111.111.111.000
1909;GENERAL C∂MARA;RS;106;38;144;263.888.888.888.888.000;736.111.111.111.111.000
4684;S«O FRANCISCO DO MARANH«O;MA;106;38;144;263.888.888.888.888.000;736.111.111.111.111.000
4967;SAPUCA÷-MIRIM;MG;159;57;216;263.888.888.888.888.000;736.111.111.111.111.000
5534;VIDEIRA;SC;159;57;216;263.888.888.888.888.000;736.111.111.111.111.000
879;CAFARNAUM;BA;120;43;163;263.803.680.981.595.000;736.196.319.018.404.000
2855;MACHACALIS;MG;120;43;163;263.803.680.981.595.000;736.196.319.018.404.000
2733;LAJE;BA;187;67;254;263.779.527.559.055.000;736.220.472.440.944.000
2753;LAP«O;BA;134;48;182;263.736.263.736.263.000;736.263.736.263.736.000
3124;MODELO;SC;67;24;91;263.736.263.736.263.000;736.263.736.263.736.000
4016;POUSO NOVO;RS;67;24;91;263.736.263.736.263.000;736.263.736.263.736.000
3966;PORTEIRAS;CE;67;24;91;263.736.263.736.263.000;736.263.736.263.736.000
576;BELA VISTA DA CAROBA;PR;67;24;91;263.736.263.736.263.000;736.263.736.263.736.000
278;APERIBê;RJ;134;48;182;263.736.263.736.263.000;736.263.736.263.736.000
1999;GUAJERU;BA;67;24;91;263.736.263.736.263.000;736.263.736.263.736.000
1594;DOIS IRM«OS DO BURITI;MS;134;48;182;263.736.263.736.263.000;736.263.736.263.736.000
1693;ERER“;CE;67;24;91;263.736.263.736.263.000;736.263.736.263.736.000
5366;TUPIRATINS;TO;67;24;91;263.736.263.736.263.000;736.263.736.263.736.000
5008;SENADOR POMPEU;CE;134;48;182;263.736.263.736.263.000;736.263.736.263.736.000
3902;PLANALTO;BA;148;53;201;263.681.592.039.800.000;736.318.407.960.199.000
4294;ROMEL∂NDIA;SC;81;29;110;263.636.363.636.363.000;736.363.636.363.636.000
1816;FLORESTA AZUL;BA;162;58;220;263.636.363.636.363.000;736.363.636.363.636.000
315;ARAGUAÄU;TO;81;29;110;263.636.363.636.363.000;736.363.636.363.636.000
2854;MACEI‡;AL;799;286;1085;263.594.470.046.082.000;736.405.529.953.917.000
2520;JAIC‡S;PI;95;34;129;263.565.891.472.868.000;736.434.108.527.131.000
463;BAIXA GRANDE DO RIBEIRO;PI;95;34;129;263.565.891.472.868.000;736.434.108.527.131.000
1499;CUBATI;PB;95;34;129;263.565.891.472.868.000;736.434.108.527.131.000
2563;JARU;RO;327;117;444;263.513.513.513.513.000;736.486.486.486.486.000
2995;MARTIN‡POLE;CE;109;39;148;263.513.513.513.513.000;736.486.486.486.486.000
4325;SABµUDIA;PR;109;39;148;263.513.513.513.513.000;736.486.486.486.486.000
4081;QUADRA;SP;109;39;148;263.513.513.513.513.000;736.486.486.486.486.000
4353;SALTO DA DIVISA;MG;137;49;186;263.440.860.215.053.000;736.559.139.784.946.000
4773;S«O JOSê DA BARRA;MG;151;54;205;263.414.634.146.341.000;736.585.365.853.658.000
56;µGUA DOCE DO NORTE;ES;165;59;224;263.392.857.142.857.000;736.607.142.857.142.000
2297;ITABAIANA;PB;179;64;243;263.374.485.596.707.000;736.625.514.403.292.000
719;BONITO;PE;221;79;300;263.333.333.333.333.000;736.666.666.666.666.000
2533;JANUµRIA;MG;375;134;509;263.261.296.660.117.000;736.738.703.339.882.000
2515;JAGUARIPE;BA;168;60;228;263.157.894.736.842.000;736.842.105.263.157.000
3203;MORRO CABEÄA NO TEMPO;PI;84;30;114;263.157.894.736.842.000;736.842.105.263.157.000
3204;MORRO DA FUMAÄA;SC;84;30;114;263.157.894.736.842.000;736.842.105.263.157.000
4315;RUBELITA;MG;84;30;114;263.157.894.736.842.000;736.842.105.263.157.000
4393;SANTA CLARA DO SUL;RS;84;30;114;263.157.894.736.842.000;736.842.105.263.157.000
700;BOM PRINC÷PIO;RS;84;30;114;263.157.894.736.842.000;736.842.105.263.157.000
382;ARINOS;MG;154;55;209;263.157.894.736.842.000;736.842.105.263.157.000
1574;DIRCE REIS;SP;84;30;114;263.157.894.736.842.000;736.842.105.263.157.000
1202;CATUJI;MG;154;55;209;263.157.894.736.842.000;736.842.105.263.157.000
1171;CASEIROS;RS;56;20;76;263.157.894.736.842.000;736.842.105.263.157.000
1985;GUABIJU;RS;56;20;76;263.157.894.736.842.000;736.842.105.263.157.000
2199;INACIOL∂NDIA;GO;140;50;190;263.157.894.736.842.000;736.842.105.263.157.000
4607;SANTO HIP‡LITO;MG;140;50;190;263.157.894.736.842.000;736.842.105.263.157.000
5009;SENADOR RUI PALMEIRA;AL;98;35;133;263.157.894.736.842.000;736.842.105.263.157.000
5029;SERRA AZUL DE MINAS;MG;98;35;133;263.157.894.736.842.000;736.842.105.263.157.000
5046;SERRA REDONDA;PB;84;30;114;263.157.894.736.842.000;736.842.105.263.157.000
5296;TORIXORêU;MT;84;30;114;263.157.894.736.842.000;736.842.105.263.157.000
524;BARRA DO CORDA;MA;283;101;384;263.020.833.333.333.000;736.979.166.666.666.000
799;BUERAREMA;BA;255;91;346;263.005.780.346.820.000;736.994.219.653.179.000
1530;CURURUPU;MA;213;76;289;262.975.778.546.712.000;737.024.221.453.287.000
3716;PEDRA DO ANTA;MG;115;41;156;262.820.512.820.512.000;737.179.487.179.487.000
2326;ITAGUARU;GO;115;41;156;262.820.512.820.512.000;737.179.487.179.487.000
3205;MORRO DA GARÄA;MG;101;36;137;262.773.722.627.737.000;737.226.277.372.262.000
2126;IBIRAPU«;BA;101;36;137;262.773.722.627.737.000;737.226.277.372.262.000
899;CAJARI;MA;202;72;274;262.773.722.627.737.000;737.226.277.372.262.000
289;APU÷;AM;188;67;255;262.745.098.039.215.000;737.254.901.960.784.000
1826;FLOR÷NEA;SP;87;31;118;262.711.864.406.779.000;737.288.135.593.220.000
1398;CORIBE;BA;87;31;118;262.711.864.406.779.000;737.288.135.593.220.000
2721;LAGOA NOVA;RN;87;31;118;262.711.864.406.779.000;737.288.135.593.220.000
3432;NOVO ORIENTE;CE;87;31;118;262.711.864.406.779.000;737.288.135.593.220.000
5370;TURMALINA;SP;87;31;118;262.711.864.406.779.000;737.288.135.593.220.000
4677;S«O FRANCISCO DE PAULA;MG;174;62;236;262.711.864.406.779.000;737.288.135.593.220.000
4332;SAIRê;PE;73;26;99;262.626.262.626.262.000;737.373.737.373.737.000
2751;LANDRI SALES;PI;73;26;99;262.626.262.626.262.000;737.373.737.373.737.000
3118;MIRIM DOCE;SC;73;26;99;262.626.262.626.262.000;737.373.737.373.737.000
1686;ENTRE RIOS DO SUL;RS;73;26;99;262.626.262.626.262.000;737.373.737.373.737.000
2175;IGUATU;PR;73;26;99;262.626.262.626.262.000;737.373.737.373.737.000
2213;INDIAROBA;SE;146;52;198;262.626.262.626.262.000;737.373.737.373.737.000
873;CAEM;BA;73;26;99;262.626.262.626.262.000;737.373.737.373.737.000
794;BRUN‡POLIS;SC;73;26;99;262.626.262.626.262.000;737.373.737.373.737.000
5353;TUNEIRAS DO OESTE;PR;146;52;198;262.626.262.626.262.000;737.373.737.373.737.000
1623;DORES DO INDAIµ;MG;191;68;259;262.548.262.548.262.000;737.451.737.451.737.000
172;ALVAR«ES;AM;250;89;339;262.536.873.156.342.000;737.463.126.843.657.000
361;ARAÈJOS;MG;118;42;160;262.500.000.000.000.000;737.500.000.000.000.000
1020;CANDEAL;BA;118;42;160;262.500.000.000.000.000;737.500.000.000.000.000
1380;CONTENDA;PR;177;63;240;262.500.000.000.000.000;737.500.000.000.000.000
2229;IOMER“;SC;59;21;80;262.500.000.000.000.000;737.500.000.000.000.000
1953;GOVERNADOR ARCHER;MA;59;21;80;262.500.000.000.000.000;737.500.000.000.000.000
4529;SANTANA DE CATAGUASES;MG;118;42;160;262.500.000.000.000.000;737.500.000.000.000.000
5350;TUNµPOLIS;SC;59;21;80;262.500.000.000.000.000;737.500.000.000.000.000
994;CAMPOS ALTOS;MG;163;58;221;262.443.438.914.027.000;737.556.561.085.972.000
217;ANAJATUBA;MA;163;58;221;262.443.438.914.027.000;737.556.561.085.972.000
538;BARRA LONGA;MG;104;37;141;262.411.347.517.730.000;737.588.652.482.269.000
4069;PRINCESA ISABEL;PB;104;37;141;262.411.347.517.730.000;737.588.652.482.269.000
168;ALTO TAQUARI;MT;149;53;202;262.376.237.623.762.000;737.623.762.376.237.000
98;ALC∂NTARAS;CE;90;32;122;262.295.081.967.213.000;737.704.918.032.786.000
574;BELA CRUZ;CE;135;48;183;262.295.081.967.213.000;737.704.918.032.786.000
489;BANNACH;PA;135;48;183;262.295.081.967.213.000;737.704.918.032.786.000
397;ARROIO DO PADRE;RS;90;32;122;262.295.081.967.213.000;737.704.918.032.786.000
1129;CARLINDA;MT;135;48;183;262.295.081.967.213.000;737.704.918.032.786.000
638;BOA ESPERANÄA;PR;90;32;122;262.295.081.967.213.000;737.704.918.032.786.000
2066;HEITORA÷;GO;90;32;122;262.295.081.967.213.000;737.704.918.032.786.000
4154;RESENDE COSTA;MG;135;48;183;262.295.081.967.213.000;737.704.918.032.786.000
4362;SALVADOR DAS MISSÂES;RS;45;16;61;262.295.081.967.213.000;737.704.918.032.786.000
3206;MORRO DO CHAPêU;BA;180;64;244;262.295.081.967.213.000;737.704.918.032.786.000
3908;PLANURA;MG;166;59;225;262.222.222.222.222.000;737.777.777.777.777.000
1898;GAROPABA;SC;121;43;164;262.195.121.951.219.000;737.804.878.048.780.000
2017;GUARACIABA;SC;76;27;103;262.135.922.330.097.000;737.864.077.669.902.000
454;BAEPENDI;MG;183;65;248;262.096.774.193.548.000;737.903.225.806.451.000
4466;SANTA MARIA DE JETIBµ;ES;183;65;248;262.096.774.193.548.000;737.903.225.806.451.000
4331;SAGRES;SP;107;38;145;262.068.965.517.241.000;737.931.034.482.758.000
2576;JECEABA;MG;169;60;229;262.008.733.624.454.000;737.991.266.375.545.000
3156;MONTE ALEGRE DO PIAU÷;PI;93;33;126;261.904.761.904.761.000;738.095.238.095.238.000
1027;C∂NDIDO GOD‡I;RS;62;22;84;261.904.761.904.761.000;738.095.238.095.238.000
923;CAMALAÈ;PB;62;22;84;261.904.761.904.761.000;738.095.238.095.238.000
1238;CERRO AZUL;PR;93;33;126;261.904.761.904.761.000;738.095.238.095.238.000
4911;S«O ROBERTO;MA;62;22;84;261.904.761.904.761.000;738.095.238.095.238.000
2383;ITAPERUÄU;PR;172;61;233;261.802.575.107.296.000;738.197.424.892.703.000
4926;S«O SEBASTI«O DO ANTA;MG;141;50;191;261.780.104.712.041.000;738.219.895.287.958.000
2347;ITAMARACµ;PE;79;28;107;261.682.242.990.654.000;738.317.757.009.345.000
3403;NOVA UNI«O;MG;158;56;214;261.682.242.990.654.000;738.317.757.009.345.000
3001;MARZAG«O;GO;79;28;107;261.682.242.990.654.000;738.317.757.009.345.000
3980;PORTO DA FOLHA;SE;158;56;214;261.682.242.990.654.000;738.317.757.009.345.000
931;CAMBARµ DO SUL;RS;127;45;172;261.627.906.976.744.000;738.372.093.023.255.000
1713;ESPINOSA;MG;175;62;237;261.603.375.527.426.000;738.396.624.472.573.000
3026;MATIP‡;MG;175;62;237;261.603.375.527.426.000;738.396.624.472.573.000
3483;OROB‡;PE;96;34;130;261.538.461.538.461.000;738.461.538.461.538.000
287;APUAREMA;BA;96;34;130;261.538.461.538.461.000;738.461.538.461.538.000
5340;TROMBAS;GO;96;34;130;261.538.461.538.461.000;738.461.538.461.538.000
0;ABADIA DE GOIµS;GO;209;74;283;261.484.098.939.929.000;738.515.901.060.070.000
1346;CONCEIÄ«O DO COITê;BA;243;86;329;261.398.176.291.793.000;738.601.823.708.206.000
254;ANITµPOLIS;SC;65;23;88;261.363.636.363.636.000;738.636.363.636.363.000
979;CAMPO GRANDE;RN;65;23;88;261.363.636.363.636.000;738.636.363.636.363.000
3631;PARAÈNA;GO;130;46;176;261.363.636.363.636.000;738.636.363.636.363.000
4367;SANANDUVA;RS;65;23;88;261.363.636.363.636.000;738.636.363.636.363.000
2470;IVATê;PR;130;46;176;261.363.636.363.636.000;738.636.363.636.363.000
2639;JUAZEIRO DO PIAU÷;PI;65;23;88;261.363.636.363.636.000;738.636.363.636.363.000
5252;TERRA NOVA;PE;65;23;88;261.363.636.363.636.000;738.636.363.636.363.000
4825;S«O JOSê DOS AUSENTES;RS;65;23;88;261.363.636.363.636.000;738.636.363.636.363.000
1119;CAREIRO DA VµRZEA;AM;229;81;310;261.290.322.580.645.000;738.709.677.419.354.000
1845;FORTALEZA DOS NOGUEIRAS;MA;82;29;111;261.261.261.261.261.000;738.738.738.738.738.000
2864;MADEIRO;PI;82;29;111;261.261.261.261.261.000;738.738.738.738.738.000
3661;PASSO DE TORRES;SC;82;29;111;261.261.261.261.261.000;738.738.738.738.738.000
4063;PRIMAVERA;PE;198;70;268;261.194.029.850.746.000;738.805.970.149.253.000
2775;LEME DO PRADO;MG;99;35;134;261.194.029.850.746.000;738.805.970.149.253.000
3695;PAULO AFONSO;BA;331;117;448;261.160.714.285.714.000;738.839.285.714.285.000
4267;RIO QUENTE;GO;116;41;157;261.146.496.815.286.000;738.853.503.184.713.000
2831;LUNARDELLI;PR;116;41;157;261.146.496.815.286.000;738.853.503.184.713.000
4591;SANTO ANT‚NIO DO MONTE;MG;218;77;295;261.016.949.152.542.000;738.983.050.847.457.000
2963;MAREMA;SC;68;24;92;260.869.565.217.391.000;739.130.434.782.608.000
3053;MEDEIROS;MG;85;30;115;260.869.565.217.391.000;739.130.434.782.608.000
3565;PALMEIR‡POLIS;TO;85;30;115;260.869.565.217.391.000;739.130.434.782.608.000
1413;CORONEL JOSê DIAS;PI;68;24;92;260.869.565.217.391.000;739.130.434.782.608.000
1557;DESTERRO DE ENTRE RIOS;MG;153;54;207;260.869.565.217.391.000;739.130.434.782.608.000
1453;CRA÷BAS;AL;153;54;207;260.869.565.217.391.000;739.130.434.782.608.000
205;AMETISTA DO SUL;RS;51;18;69;260.869.565.217.391.000;739.130.434.782.608.000
407;ARVOREZINHA;RS;85;30;115;260.869.565.217.391.000;739.130.434.782.608.000
358;ARATU÷PE;BA;136;48;184;260.869.565.217.391.000;739.130.434.782.608.000
5280;TIRADENTES DO SUL;RS;102;36;138;260.869.565.217.391.000;739.130.434.782.608.000
5416;UNI«O DO OESTE;SC;102;36;138;260.869.565.217.391.000;739.130.434.782.608.000
5545;VILA NOVA DO SUL;RS;68;24;92;260.869.565.217.391.000;739.130.434.782.608.000
1345;CONCEIÄ«O DO CASTELO;ES;156;55;211;260.663.507.109.004.000;739.336.492.890.995.000
1427;CORREIA PINTO;SC;122;43;165;260.606.060.606.060.000;739.393.939.393.939.000
4658;S«O FELIPE DO OESTE;RO;122;43;165;260.606.060.606.060.000;739.393.939.393.939.000
3584;PARµ;PA;1870;659;2529;260.577.303.281.929.000;739.422.696.718.070.000
832;CABIXI;RO;105;37;142;260.563.380.281.690.000;739.436.619.718.309.000
754;BRASIL NOVO;PA;105;37;142;260.563.380.281.690.000;739.436.619.718.309.000
399;ARROIO DO TIGRE;RS;88;31;119;260.504.201.680.672.000;739.495.798.319.327.000
1356;CONC‡RDIA;SC;176;62;238;260.504.201.680.672.000;739.495.798.319.327.000
1239;CERRO BRANCO;RS;88;31;119;260.504.201.680.672.000;739.495.798.319.327.000
1879;FRUTA DE LEITE;MG;88;31;119;260.504.201.680.672.000;739.495.798.319.327.000
1948;GONÄALVES DIAS;MA;88;31;119;260.504.201.680.672.000;739.495.798.319.327.000
1928;GLORINHA;RS;88;31;119;260.504.201.680.672.000;739.495.798.319.327.000
4739;S«O JO«O DO CAIUµ;PR;88;31;119;260.504.201.680.672.000;739.495.798.319.327.000
5399;UIRAPURU;GO;88;31;119;260.504.201.680.672.000;739.495.798.319.327.000
3207;MORRO DO CHAPêU DO PIAU÷;PI;71;25;96;260.416.666.666.666.000;739.583.333.333.333.000
5004;SENADOR JOSê BENTO;MG;71;25;96;260.416.666.666.666.000;739.583.333.333.333.000
3328;NOVA CANTU;PR;108;38;146;260.273.972.602.739.000;739.726.027.397.260.000
4274;RIO VERMELHO;MG;162;57;219;260.273.972.602.739.000;739.726.027.397.260.000
4386;SANTA BR÷GIDA;BA;108;38;146;260.273.972.602.739.000;739.726.027.397.260.000
2249;IPIRANGA DO NORTE;MT;108;38;146;260.273.972.602.739.000;739.726.027.397.260.000
1437;CORUMBIARA;RO;162;57;219;260.273.972.602.739.000;739.726.027.397.260.000
424;ATALêIA;MG;162;57;219;260.273.972.602.739.000;739.726.027.397.260.000
885;CAIANA;MG;108;38;146;260.273.972.602.739.000;739.726.027.397.260.000
188;AMAPµ;AP;1063;374;1437;260.264.439.805.149.000;739.735.560.194.850.000
1832;FORMOSA DA SERRA NEGRA;MA;91;32;123;260.162.601.626.016.000;739.837.398.373.983.000
3293;NONOAI;RS;91;32;123;260.162.601.626.016.000;739.837.398.373.983.000
3110;MIRANTE;BA;91;32;123;260.162.601.626.016.000;739.837.398.373.983.000
2834;LUTêCIA;SP;128;45;173;260.115.606.936.416.000;739.884.393.063.583.000
2151;IGACI;AL;128;45;173;260.115.606.936.416.000;739.884.393.063.583.000
1401;COROACI;MG;165;58;223;260.089.686.098.654.000;739.910.313.901.345.000
5294;TONANTINS;AM;165;58;223;260.089.686.098.654.000;739.910.313.901.345.000
347;ARARENDµ;CE;74;26;100;260.000.000.000.000.000;740.000.000.000.000.000
943;CAMPESTRE;MG;148;52;200;260.000.000.000.000.000;740.000.000.000.000.000
615;BERNARDINO DE CAMPOS;SP;148;52;200;260.000.000.000.000.000;740.000.000.000.000.000
5509;VERDEL∂NDIA;MG;168;59;227;259.911.894.273.127.000;740.088.105.726.872.000
30;ADAMANTINA;SP;188;66;254;259.842.519.685.039.000;740.157.480.314.960.000
2028;GUARANI DE GOIµS;GO;94;33;127;259.842.519.685.039.000;740.157.480.314.960.000
1725;ESTIVA;MG;94;33;127;259.842.519.685.039.000;740.157.480.314.960.000
5148;TABOCAS DO BREJO VELHO;BA;94;33;127;259.842.519.685.039.000;740.157.480.314.960.000
4682;S«O FRANCISCO DO GL‡RIA;MG;94;33;127;259.842.519.685.039.000;740.157.480.314.960.000
1681;ENTRE FOLHAS;MG;171;60;231;259.740.259.740.259.000;740.259.740.259.740.000
1653;EIRUNEPê;AM;228;80;308;259.740.259.740.259.000;740.259.740.259.740.000
95;ALAMBARI;SP;114;40;154;259.740.259.740.259.000;740.259.740.259.740.000
606;BENJAMIN CONSTANT;AM;285;100;385;259.740.259.740.259.000;740.259.740.259.740.000
2762;LASTRO;PB;57;20;77;259.740.259.740.259.000;740.259.740.259.740.000
4728;S«O JO«O DA URTIGA;RS;57;20;77;259.740.259.740.259.000;740.259.740.259.740.000
5168;TAMARANA;PR;191;67;258;259.689.922.480.620.000;740.310.077.519.379.000
4193;RIBEIR«O CASCALHEIRA;MT;134;47;181;259.668.508.287.292.000;740.331.491.712.707.000
198;AMAZONAS;AM;1326;465;1791;259.631.490.787.269.000;740.368.509.212.730.000
1804;FLOR DA SERRA DO SUL;PR;77;27;104;259.615.384.615.384.000;740.384.615.384.615.000
5375;TURVEL∂NDIA;GO;97;34;131;259.541.984.732.824.000;740.458.015.267.175.000
5516;VERTENTES;PE;97;34;131;259.541.984.732.824.000;740.458.015.267.175.000
5150;TABULEIRO;MG;117;41;158;259.493.670.886.075.000;740.506.329.113.924.000
164;ALTO PIQUIRI;PR;137;48;185;259.459.459.459.459.000;740.540.540.540.540.000
4741;S«O JO«O DO CARÈ;MA;137;48;185;259.459.459.459.459.000;740.540.540.540.540.000
5202;TAQUARANA;AL;137;48;185;259.459.459.459.459.000;740.540.540.540.540.000
3162;MONTE AZUL PAULISTA;SP;157;55;212;259.433.962.264.150.000;740.566.037.735.849.000
3746;PEDRO LEOPOLDO;MG;337;118;455;259.340.659.340.659.000;740.659.340.659.340.000
3146;MONTADAS;PB;80;28;108;259.259.259.259.259.000;740.740.740.740.740.000
3177;MONTE SANTO DO TOCANTINS;TO;80;28;108;259.259.259.259.259.000;740.740.740.740.740.000
2869;MAETINGA;BA;80;28;108;259.259.259.259.259.000;740.740.740.740.740.000
2466;IUIU;BA;80;28;108;259.259.259.259.259.000;740.740.740.740.740.000
2499;JACUIZINHO;RS;80;28;108;259.259.259.259.259.000;740.740.740.740.740.000
192;AMARAL FERRADOR;RS;80;28;108;259.259.259.259.259.000;740.740.740.740.740.000
695;BOM JESUS DO SUL;PR;40;14;54;259.259.259.259.259.000;740.740.740.740.740.000
825;CAATIBA;BA;120;42;162;259.259.259.259.259.000;740.740.740.740.740.000
906;CAJUEIRO DA PRAIA;PI;100;35;135;259.259.259.259.259.000;740.740.740.740.740.000
1122;CARIDADE DO PIAU÷;PI;60;21;81;259.259.259.259.259.000;740.740.740.740.740.000
2204;INDAIAL;SC;220;77;297;259.259.259.259.259.000;740.740.740.740.740.000
1671;ENCANTO;RN;60;21;81;259.259.259.259.259.000;740.740.740.740.740.000
1331;COMERCINHO;MG;100;35;135;259.259.259.259.259.000;740.740.740.740.740.000
5199;TAQUARAÄU DE MINAS;MG;140;49;189;259.259.259.259.259.000;740.740.740.740.740.000
2124;IBIRAMA;SC;143;50;193;259.067.357.512.953.000;740.932.642.487.046.000
3499;OURO BRANCO;AL;143;50;193;259.067.357.512.953.000;740.932.642.487.046.000
4410;SANTA CRUZ DO ESCALVADO;MG;143;50;193;259.067.357.512.953.000;740.932.642.487.046.000
4318;RUBIM;MG;123;43;166;259.036.144.578.313.000;740.963.855.421.686.000
2372;ITAPAGê;CE;246;86;332;259.036.144.578.313.000;740.963.855.421.686.000
2357;ITAMBê;PR;123;43;166;259.036.144.578.313.000;740.963.855.421.686.000
2971;MARIAN‡POLIS DO TOCANTINS;TO;103;36;139;258.992.805.755.395.000;741.007.194.244.604.000
3463;OL÷MPIO NORONHA;MG;103;36;139;258.992.805.755.395.000;741.007.194.244.604.000
3705;Pê DE SERRA;BA;103;36;139;258.992.805.755.395.000;741.007.194.244.604.000
1447;COTRIGUAÄU;MT;206;72;278;258.992.805.755.395.000;741.007.194.244.604.000
1052;CANUDOS;BA;103;36;139;258.992.805.755.395.000;741.007.194.244.604.000
892;CAIÄARA DO RIO DO VENTO;RN;103;36;139;258.992.805.755.395.000;741.007.194.244.604.000
283;APIÈNA;SC;103;36;139;258.992.805.755.395.000;741.007.194.244.604.000
4054;PRESIDENTE MêDICI;RO;186;65;251;258.964.143.426.294.000;741.035.856.573.705.000
3617;PARANAPOEMA;PR;83;29;112;258.928.571.428.571.000;741.071.428.571.428.000
3191;MORAÈJO;CE;83;29;112;258.928.571.428.571.000;741.071.428.571.428.000
3286;NINHEIRA;MG;83;29;112;258.928.571.428.571.000;741.071.428.571.428.000
1134;CARMêSIA;MG;83;29;112;258.928.571.428.571.000;741.071.428.571.428.000
4801;S«O JOSê DO CERRITO;SC;83;29;112;258.928.571.428.571.000;741.071.428.571.428.000
4904;S«O PEDRO DO TURVO;SP;166;58;224;258.928.571.428.571.000;741.071.428.571.428.000
2493;JACINTO;MG;146;51;197;258.883.248.730.964.000;741.116.751.269.035.000
4389;SANTA CEC÷LIA;PB;146;51;197;258.883.248.730.964.000;741.116.751.269.035.000
4417;SANTA ERNESTINA;SP;126;44;170;258.823.529.411.764.000;741.176.470.588.235.000
106;ALEGRETE DO PIAU÷;PI;63;22;85;258.823.529.411.764.000;741.176.470.588.235.000
1385;COQUEIROS DO SUL;RS;63;22;85;258.823.529.411.764.000;741.176.470.588.235.000
1865;FRANCISC‡POLIS;MG;126;44;170;258.823.529.411.764.000;741.176.470.588.235.000
5172;TAMBORIL DO PIAU÷;PI;63;22;85;258.823.529.411.764.000;741.176.470.588.235.000
2324;ITAGUARA;MG;169;59;228;258.771.929.824.561.000;741.228.070.175.438.000
941;CAMPANµRIO;MG;106;37;143;258.741.258.741.258.000;741.258.741.258.741.000
966;CAMPO AZUL;MG;86;30;116;258.620.689.655.172.000;741.379.310.344.827.000
388;ARMAZêM;SC;86;30;116;258.620.689.655.172.000;741.379.310.344.827.000
3567;PALMIN‡POLIS;GO;86;30;116;258.620.689.655.172.000;741.379.310.344.827.000
3509;OURO VERDE DE MINAS;MG;129;45;174;258.620.689.655.172.000;741.379.310.344.827.000
1795;FIGUEIRA;PR;152;53;205;258.536.585.365.853.000;741.463.414.634.146.000
5244;TERESINA DE GOIµS;GO;109;38;147;258.503.401.360.544.000;741.496.598.639.455.000
5015;SENHORA DO PORTO;MG;109;38;147;258.503.401.360.544.000;741.496.598.639.455.000
1322;COL‚NIA DO PIAU÷;PI;66;23;89;258.426.966.292.134.000;741.573.033.707.865.000
1446;COTIPOR«;RS;66;23;89;258.426.966.292.134.000;741.573.033.707.865.000
1635;DOUTOR PEDRINHO;SC;66;23;89;258.426.966.292.134.000;741.573.033.707.865.000
4284;RODEIO BONITO;RS;66;23;89;258.426.966.292.134.000;741.573.033.707.865.000
3062;MENDONÄA;SP;132;46;178;258.426.966.292.134.000;741.573.033.707.865.000
3920;POÄO REDONDO;SE;155;54;209;258.373.205.741.626.000;741.626.794.258.373.000
3556;PALMEIRA D'OESTE;SP;89;31;120;258.333.333.333.333.000;741.666.666.666.666.000
3598;PARA÷SO;SC;89;31;120;258.333.333.333.333.000;741.666.666.666.666.000
4420;SANTA Fê DE MINAS;MG;89;31;120;258.333.333.333.333.000;741.666.666.666.666.000
1205;CATURAMA;BA;89;31;120;258.333.333.333.333.000;741.666.666.666.666.000
2009;GUAP‡;GO;178;62;240;258.333.333.333.333.000;741.666.666.666.666.000
161;ALTO PARA÷SO DE GOIµS;GO;112;39;151;258.278.145.695.364.000;741.721.854.304.635.000
764;BRAÈNA;SP;112;39;151;258.278.145.695.364.000;741.721.854.304.635.000
4432;SANTA HELENA DE MINAS;MG;112;39;151;258.278.145.695.364.000;741.721.854.304.635.000
4231;RIO DE CONTAS;BA;112;39;151;258.278.145.695.364.000;741.721.854.304.635.000
2486;JACARAÈ;PB;112;39;151;258.278.145.695.364.000;741.721.854.304.635.000
2574;JAUPACI;GO;69;24;93;258.064.516.129.032.000;741.935.483.870.967.000
3058;MELEIRO;SC;69;24;93;258.064.516.129.032.000;741.935.483.870.967.000
3276;NE‡POLIS;SE;161;56;217;258.064.516.129.032.000;741.935.483.870.967.000
3164;MONTE BELO DO SUL;RS;69;24;93;258.064.516.129.032.000;741.935.483.870.967.000
4155;RESERVA;PR;184;64;248;258.064.516.129.032.000;741.935.483.870.967.000
4553;SANTAN‡POLIS;BA;115;40;155;258.064.516.129.032.000;741.935.483.870.967.000
1128;CARIÈS;CE;115;40;155;258.064.516.129.032.000;741.935.483.870.967.000
2107;IBIASSUC“;BA;69;24;93;258.064.516.129.032.000;741.935.483.870.967.000
2159;IGARAPê-AÄU;PA;230;80;310;258.064.516.129.032.000;741.935.483.870.967.000
1854;FRANCIN‡POLIS;PI;69;24;93;258.064.516.129.032.000;741.935.483.870.967.000
1908;GEMINIANO;PI;92;32;124;258.064.516.129.032.000;741.935.483.870.967.000
1290;CLµUDIA;MT;92;32;124;258.064.516.129.032.000;741.935.483.870.967.000
1634;DOUTOR MAUR÷CIO CARDOSO;RS;46;16;62;258.064.516.129.032.000;741.935.483.870.967.000
1658;ELESB«O VELOSO;PI;69;24;93;258.064.516.129.032.000;741.935.483.870.967.000
4997;SENADOR AMARAL;MG;92;32;124;258.064.516.129.032.000;741.935.483.870.967.000
5221;TAVARES;RS;69;24;93;258.064.516.129.032.000;741.935.483.870.967.000
1576;DISTRITO FEDERAL;DF;2264;787;3051;257.948.213.700.426.000;742.051.786.299.573.000
1887;GALILêIA;MG;164;57;221;257.918.552.036.199.000;742.081.447.963.800.000
4539;SANTANA DO ITARARê;PR;118;41;159;257.861.635.220.125.000;742.138.364.779.874.000
4928;S«O SEBASTI«O DO MARANH«O;MG;118;41;159;257.861.635.220.125.000;742.138.364.779.874.000
4448;SANTA LUZIA;PB;95;33;128;257.812.500.000.000.000;742.187.500.000.000.000
4195;RIBEIR«O CORRENTE;SP;95;33;128;257.812.500.000.000.000;742.187.500.000.000.000
2666;JURIPIRANGA;PB;95;33;128;257.812.500.000.000.000;742.187.500.000.000.000
2397;ITAPIRAPU« PAULISTA;SP;95;33;128;257.812.500.000.000.000;742.187.500.000.000.000
1721;ESTAÄ«O;RS;95;33;128;257.812.500.000.000.000;742.187.500.000.000.000
2232;IPANEMA;MG;190;66;256;257.812.500.000.000.000;742.187.500.000.000.000
5432;URUBICI;SC;95;33;128;257.812.500.000.000.000;742.187.500.000.000.000
1554;DESCANSO;SC;72;25;97;257.731.958.762.886.000;742.268.041.237.113.000
3074;MIGUEL LE«O;PI;72;25;97;257.731.958.762.886.000;742.268.041.237.113.000
4721;S«O JO«O DA FRONTEIRA;PI;72;25;97;257.731.958.762.886.000;742.268.041.237.113.000
2948;MARAVILHA;AL;98;34;132;257.575.757.575.757.000;742.424.242.424.242.000
2431;ITATIM;BA;98;34;132;257.575.757.575.757.000;742.424.242.424.242.000
1915;GENTIL;RS;49;17;66;257.575.757.575.757.000;742.424.242.424.242.000
614;BERNARDINO BATISTA;PB;49;17;66;257.575.757.575.757.000;742.424.242.424.242.000
4659;S«O FêLIX;BA;173;60;233;257.510.729.613.733.000;742.489.270.386.266.000
527;BARRA DO JACARê;PR;124;43;167;257.485.029.940.119.000;742.514.970.059.880.000
416;ASSUNÄ«O;PB;75;26;101;257.425.742.574.257.000;742.574.257.425.742.000
53;µGUA COMPRIDA;MG;75;26;101;257.425.742.574.257.000;742.574.257.425.742.000
1307;COITê DO N‡IA;AL;75;26;101;257.425.742.574.257.000;742.574.257.425.742.000
3190;MORADA NOVA DE MINAS;MG;150;52;202;257.425.742.574.257.000;742.574.257.425.742.000
4031;PRATA;PB;75;26;101;257.425.742.574.257.000;742.574.257.425.742.000
5287;TOCOS DO MOJI;MG;75;26;101;257.425.742.574.257.000;742.574.257.425.742.000
4463;SANTA MARIA DA VIT‡RIA;BA;176;61;237;257.383.966.244.725.000;742.616.033.755.274.000
3577;PANELAS;PE;101;35;136;257.352.941.176.470.000;742.647.058.823.529.000
2277;IRAMAIA;BA;127;44;171;257.309.941.520.467.000;742.690.058.479.532.000
176;µLVARO DE CARVALHO;SP;127;44;171;257.309.941.520.467.000;742.690.058.479.532.000
5178;TANHAÄU;BA;127;44;171;257.309.941.520.467.000;742.690.058.479.532.000
5157;TAGUA÷;SP;153;53;206;257.281.553.398.058.000;742.718.446.601.941.000
3269;NAZARê DA MATA;PE;257;89;346;257.225.433.526.011.000;742.774.566.473.988.000
4388;SANTA CATARINA;SC;1271;440;1711;257.159.555.815.312.000;742.840.444.184.687.000
2827;LUISL∂NDIA;MG;130;45;175;257.142.857.142.857.000;742.857.142.857.142.000
1867;FRECHEIRINHA;CE;78;27;105;257.142.857.142.857.000;742.857.142.857.142.000
1757;FARTURA DO PIAU÷;PI;78;27;105;257.142.857.142.857.000;742.857.142.857.142.000
5054;SERRANOS;MG;104;36;140;257.142.857.142.857.000;742.857.142.857.142.000
5288;TOLEDO;MG;78;27;105;257.142.857.142.857.000;742.857.142.857.142.000
1562;DIAMANTE DO NORTE;PR;133;46;179;256.983.240.223.463.000;743.016.759.776.536.000
3667;PATIS;MG;81;28;109;256.880.733.944.954.000;743.119.266.055.045.000
1431;CORT“S;PE;136;47;183;256.830.601.092.896.000;743.169.398.907.103.000
1422;C‡RREGO DANTA;MG;136;47;183;256.830.601.092.896.000;743.169.398.907.103.000
4855;S«O MARTINHO;SC;55;19;74;256.756.756.756.756.000;743.243.243.243.243.000
4208;RIFAINA;SP;84;29;113;256.637.168.141.592.000;743.362.831.858.407.000
4283;RODEIO;SC;113;39;152;256.578.947.368.421.000;743.421.052.631.578.000
3532;PAINEIRAS;MG;113;39;152;256.578.947.368.421.000;743.421.052.631.578.000
5077;SIDER‡POLIS;SC;113;39;152;256.578.947.368.421.000;743.421.052.631.578.000
4120;QUIXERê;CE;142;49;191;256.544.502.617.801.000;743.455.497.382.198.000
4454;SANTA LUZIA DO OESTE;RO;142;49;191;256.544.502.617.801.000;743.455.497.382.198.000
5524;VIC“NCIA;PE;229;79;308;256.493.506.493.506.000;743.506.493.506.493.000
4303;ROQUE GONZALES;RS;58;20;78;256.410.256.410.256.000;743.589.743.589.743.000
2075;HIDROLINA;GO;87;30;117;256.410.256.410.256.000;743.589.743.589.743.000
247;∂NGULO;PR;116;40;156;256.410.256.410.256.000;743.589.743.589.743.000
234;ANDRê DA ROCHA;RS;58;20;78;256.410.256.410.256.000;743.589.743.589.743.000
138;ALTANEIRA;CE;58;20;78;256.410.256.410.256.000;743.589.743.589.743.000
747;BRAGA;RS;58;20;78;256.410.256.410.256.000;743.589.743.589.743.000
744;BOZANO;RS;58;20;78;256.410.256.410.256.000;743.589.743.589.743.000
1138;CARMO DE MINAS;MG;206;71;277;256.317.689.530.685.000;743.682.310.469.314.000
5339;TRIZIDELA DO VALE;MA;177;61;238;256.302.521.008.403.000;743.697.478.991.596.000
2976;MARIL∂NDIA;ES;148;51;199;256.281.407.035.175.000;743.718.592.964.824.000
2924;MARA ROSA;GO;151;52;203;256.157.635.467.980.000;743.842.364.532.019.000
3257;NARANDIBA;SP;122;42;164;256.097.560.975.609.000;743.902.439.024.390.000
3713;PEDRA BRANCA;PB;61;21;82;256.097.560.975.609.000;743.902.439.024.390.000
3917;POÄO DAS TRINCHEIRAS;AL;93;32;125;256.000.000.000.000.000;744.000.000.000.000.000
3561;PALMEIRAS;BA;93;32;125;256.000.000.000.000.000;744.000.000.000.000.000
3696;PAULO BENTO;RS;93;32;125;256.000.000.000.000.000;744.000.000.000.000.000
730;BORµ;SP;93;32;125;256.000.000.000.000.000;744.000.000.000.000.000
5188;TAPEROµ;PB;93;32;125;256.000.000.000.000.000;744.000.000.000.000.000
4800;S«O JOSê DO CEDRO;SC;93;32;125;256.000.000.000.000.000;744.000.000.000.000.000
180;ALVORADA;TO;128;44;172;255.813.953.488.372.000;744.186.046.511.627.000
1429;CORRENTES;PE;96;33;129;255.813.953.488.372.000;744.186.046.511.627.000
1609;DOM MACEDO COSTA;BA;64;22;86;255.813.953.488.372.000;744.186.046.511.627.000
3640;PARIPUEIRA;AL;128;44;172;255.813.953.488.372.000;744.186.046.511.627.000
3453;‡LEO;SP;96;33;129;255.813.953.488.372.000;744.186.046.511.627.000
3977;PORTO BARREIRO;PR;96;33;129;255.813.953.488.372.000;744.186.046.511.627.000
4474;SANTA MARIA MADALENA;RJ;160;55;215;255.813.953.488.372.000;744.186.046.511.627.000
4151;RENASCENÄA;PR;64;22;86;255.813.953.488.372.000;744.186.046.511.627.000
2957;MARCOL∂NDIA;PI;64;22;86;255.813.953.488.372.000;744.186.046.511.627.000
3145;MONSENHOR TABOSA;CE;96;33;129;255.813.953.488.372.000;744.186.046.511.627.000
3679;PAU D'ARCO;PA;163;56;219;255.707.762.557.077.000;744.292.237.442.922.000
2729;LAGOINHA;SP;131;45;176;255.681.818.181.818.000;744.318.181.818.181.000
2531;JANGADA;MT;99;34;133;255.639.097.744.360.000;744.360.902.255.639.000
3712;PEDRA BONITA;MG;99;34;133;255.639.097.744.360.000;744.360.902.255.639.000
3794;PIAU;MG;99;34;133;255.639.097.744.360.000;744.360.902.255.639.000
4304;RORAIMA;RR;1168;401;1569;255.576.800.509.878.000;744.423.199.490.121.000
2718;LAGOA GRANDE;PE;134;46;180;255.555.555.555.555.000;744.444.444.444.444.000
557;BARROCAS;BA;134;46;180;255.555.555.555.555.000;744.444.444.444.444.000
1110;CARAÈBAS DO PIAU÷;PI;67;23;90;255.555.555.555.555.000;744.444.444.444.444.000
4629;S«O BONIFµCIO;SC;67;23;90;255.555.555.555.555.000;744.444.444.444.444.000
5023;SêRIO;RS;67;23;90;255.555.555.555.555.000;744.444.444.444.444.000
2207;INDEPEND“NCIA;CE;102;35;137;255.474.452.554.744.000;744.525.547.445.255.000
1746;EXU;PE;102;35;137;255.474.452.554.744.000;744.525.547.445.255.000
4746;S«O JO«O DO MANTENINHA;MG;102;35;137;255.474.452.554.744.000;744.525.547.445.255.000
389;ARNEIROZ;CE;70;24;94;255.319.148.936.170.000;744.680.851.063.829.000
3098;MIRADOR;MA;105;36;141;255.319.148.936.170.000;744.680.851.063.829.000
2943;MARAPOAMA;SP;70;24;94;255.319.148.936.170.000;744.680.851.063.829.000
3209;MORRO GRANDE;SC;70;24;94;255.319.148.936.170.000;744.680.851.063.829.000
3721;PEDRA MOLE;SE;70;24;94;255.319.148.936.170.000;744.680.851.063.829.000
3555;PALMEIRA DO PIAU÷;PI;70;24;94;255.319.148.936.170.000;744.680.851.063.829.000
5413;UNI«O DA SERRA;RS;70;24;94;255.319.148.936.170.000;744.680.851.063.829.000
420;ATALAIA;PR;108;37;145;255.172.413.793.103.000;744.827.586.206.896.000
727;BOQUEIR«O DO PIAU÷;PI;108;37;145;255.172.413.793.103.000;744.827.586.206.896.000
1777;FELISBURGO;MG;108;37;145;255.172.413.793.103.000;744.827.586.206.896.000
2064;GUZOL∂NDIA;SP;108;37;145;255.172.413.793.103.000;744.827.586.206.896.000
2059;GURINHAT«;MG;108;37;145;255.172.413.793.103.000;744.827.586.206.896.000
679;BOM JESUS;SC;73;25;98;255.102.040.816.326.000;744.897.959.183.673.000
513;BARRA D'ALC∂NTARA;PI;73;25;98;255.102.040.816.326.000;744.897.959.183.673.000
3469;OLIVEIRA DE FµTIMA;TO;73;25;98;255.102.040.816.326.000;744.897.959.183.673.000
4882;S«O NICOLAU;RS;73;25;98;255.102.040.816.326.000;744.897.959.183.673.000
2736;LAJEADO;TO;111;38;149;255.033.557.046.979.000;744.966.442.953.020.000
5001;SENADOR FIRMINO;MG;111;38;149;255.033.557.046.979.000;744.966.442.953.020.000
1210;CAXAMBU;MG;260;89;349;255.014.326.647.564.000;744.985.673.352.435.000
2407;ITAPORANGA;PB;187;64;251;254.980.079.681.274.000;745.019.920.318.725.000
1195;CATENDE;PE;301;103;404;254.950.495.049.504.000;745.049.504.950.495.000
1752;FARIAS BRITO;CE;76;26;102;254.901.960.784.313.000;745.098.039.215.686.000
1976;GRANJEIRO;CE;76;26;102;254.901.960.784.313.000;745.098.039.215.686.000
826;CABACEIRAS;PB;76;26;102;254.901.960.784.313.000;745.098.039.215.686.000
2588;JER‚NIMO MONTEIRO;ES;152;52;204;254.901.960.784.313.000;745.098.039.215.686.000
3330;NOVA COLINAS;MA;76;26;102;254.901.960.784.313.000;745.098.039.215.686.000
3692;PAULISTANA;PI;76;26;102;254.901.960.784.313.000;745.098.039.215.686.000
4824;S«O JOSê DO XINGU;MT;114;39;153;254.901.960.784.313.000;745.098.039.215.686.000
5308;TRAJANO DE MORAIS;RJ;190;65;255;254.901.960.784.313.000;745.098.039.215.686.000
3619;PARANATAMA;PE;117;40;157;254.777.070.063.694.000;745.222.929.936.305.000
534;BARRA DO ROCHA;BA;117;40;157;254.777.070.063.694.000;745.222.929.936.305.000
448;BABAÄUL∂NDIA;TO;117;40;157;254.777.070.063.694.000;745.222.929.936.305.000
4711;S«O JER‚NIMO DA SERRA;PR;120;41;161;254.658.385.093.167.000;745.341.614.906.832.000
395;ARRAIAS;TO;161;55;216;254.629.629.629.629.000;745.370.370.370.370.000
1005;CAMPOS VERDES;GO;123;42;165;254.545.454.545.454.000;745.454.545.454.545.000
1174;CASSERENGUE;PB;82;28;110;254.545.454.545.454.000;745.454.545.454.545.000
1660;ELISEU MARTINS;PI;82;28;110;254.545.454.545.454.000;745.454.545.454.545.000
2440;ITAUEIRA;PI;82;28;110;254.545.454.545.454.000;745.454.545.454.545.000
4461;SANTA MARIA DA BOA VISTA;PE;249;85;334;254.491.017.964.071.000;745.508.982.035.928.000
4028;PRAINHA;PA;170;58;228;254.385.964.912.280.000;745.614.035.087.719.000
1889;GALV«O;SC;85;29;114;254.385.964.912.280.000;745.614.035.087.719.000
4593;SANTO ANT‚NIO DO PARA÷SO;PR;85;29;114;254.385.964.912.280.000;745.614.035.087.719.000
4626;S«O BERNARDINO;SC;85;29;114;254.385.964.912.280.000;745.614.035.087.719.000
1037;CANGUÄU;RS;258;88;346;254.335.260.115.606.000;745.664.739.884.393.000
1408;CORONEL EZEQUIEL;RN;88;30;118;254.237.288.135.593.000;745.762.711.864.406.000
4276;RIOZINHO;RS;88;30;118;254.237.288.135.593.000;745.762.711.864.406.000
2859;MACHADOS;PE;132;45;177;254.237.288.135.593.000;745.762.711.864.406.000
2400;ITAPITANGA;BA;135;46;181;254.143.646.408.839.000;745.856.353.591.160.000
3406;NOVA VENEZA;SC;91;31;122;254.098.360.655.737.000;745.901.639.344.262.000
4299;RONDON;PR;91;31;122;254.098.360.655.737.000;745.901.639.344.262.000
678;BOM JARDIM DE MINAS;MG;91;31;122;254.098.360.655.737.000;745.901.639.344.262.000
5527;VICENTIN‡POLIS;GO;91;31;122;254.098.360.655.737.000;745.901.639.344.262.000
1525;CURRAL VELHO;PB;47;16;63;253.968.253.968.253.000;746.031.746.031.746.000
4404;SANTA CRUZ DE GOIµS;GO;97;33;130;253.846.153.846.153.000;746.153.846.153.846.000
1336;CONCEIÄ«O DA BARRA DE MINAS;MG;147;50;197;253.807.106.598.984.000;746.192.893.401.015.000
1535;DAMIAN‡POLIS;GO;50;17;67;253.731.343.283.582.000;746.268.656.716.417.000
22;ACAU«;PI;50;17;67;253.731.343.283.582.000;746.268.656.716.417.000
2829;LUIZI∂NIA;SP;100;34;134;253.731.343.283.582.000;746.268.656.716.417.000
4606;SANTO EXPEDITO DO SUL;RS;50;17;67;253.731.343.283.582.000;746.268.656.716.417.000
1913;GENERAL SALGADO;SP;203;69;272;253.676.470.588.235.000;746.323.529.411.764.000
4878;S«O MIGUEL DO TAPUIO;PI;103;35;138;253.623.188.405.797.000;746.376.811.594.202.000
1958;GOVERNADOR JORGE TEIXEIRA;RO;159;54;213;253.521.126.760.563.000;746.478.873.239.436.000
1748;FAGUNDES VARELA;RS;53;18;71;253.521.126.760.563.000;746.478.873.239.436.000
1552;DERRUBADAS;RS;53;18;71;253.521.126.760.563.000;746.478.873.239.436.000
677;BOM JARDIM DE GOIµS;GO;106;36;142;253.521.126.760.563.000;746.478.873.239.436.000
4289;ROLADOR;RS;53;18;71;253.521.126.760.563.000;746.478.873.239.436.000
5591;WITMARSUM;SC;53;18;71;253.521.126.760.563.000;746.478.873.239.436.000
2919;MANTENA;MG;215;73;288;253.472.222.222.222.000;746.527.777.777.777.000
256;ANTA GORDA;RS;56;19;75;253.333.333.333.333.000;746.666.666.666.666.000
1573;DIORAMA;GO;56;19;75;253.333.333.333.333.000;746.666.666.666.666.000
1971;GRAMADO DOS LOUREIROS;RS;56;19;75;253.333.333.333.333.000;746.666.666.666.666.000
5358;TUPANCI DO SUL;RS;56;19;75;253.333.333.333.333.000;746.666.666.666.666.000
380;ARGIRITA;MG;115;39;154;253.246.753.246.753.000;746.753.246.753.246.000
4051;PRESIDENTE KUBITSCHEK;MG;115;39;154;253.246.753.246.753.000;746.753.246.753.246.000
4114;QUIXABA;PE;59;20;79;253.164.556.962.025.000;746.835.443.037.974.000
3479;ORIZ∂NIA;MG;118;40;158;253.164.556.962.025.000;746.835.443.037.974.000
872;CACULê;BA;118;40;158;253.164.556.962.025.000;746.835.443.037.974.000
4807;S«O JOSê DO HORT“NCIO;RS;59;20;79;253.164.556.962.025.000;746.835.443.037.974.000
1483;CRUZ DAS ALMAS;BA;366;124;490;253.061.224.489.795.000;746.938.775.510.204.000
778;BREJO DO PIAU÷;PI;62;21;83;253.012.048.192.771.000;746.987.951.807.228.000
4397;SANTA CRUZ;PB;62;21;83;253.012.048.192.771.000;746.987.951.807.228.000
2598;JOA÷MA;MG;186;63;249;253.012.048.192.771.000;746.987.951.807.228.000
5310;TRAVESSEIRO;RS;62;21;83;253.012.048.192.771.000;746.987.951.807.228.000
2334;ITAIPê;MG;127;43;170;252.941.176.470.588.000;747.058.823.529.411.000
595;BELO CAMPO;BA;127;43;170;252.941.176.470.588.000;747.058.823.529.411.000
1822;FLORIANO PEIXOTO;RS;65;22;87;252.873.563.218.390.000;747.126.436.781.609.000
2895;MAMPITUBA;RS;65;22;87;252.873.563.218.390.000;747.126.436.781.609.000
2867;M«E D'µGUA;PB;65;22;87;252.873.563.218.390.000;747.126.436.781.609.000
4527;SANTANA DA PONTE PENSA;SP;65;22;87;252.873.563.218.390.000;747.126.436.781.609.000
4893;S«O PEDRO DA SERRA;RS;65;22;87;252.873.563.218.390.000;747.126.436.781.609.000
4708;S«O GONÄALO DOS CAMPOS;BA;331;112;443;252.821.670.428.893.000;747.178.329.571.106.000
4006;PORTO XAVIER;RS;68;23;91;252.747.252.747.252.000;747.252.747.252.747.000
1683;ENTRE RIOS;SC;68;23;91;252.747.252.747.252.000;747.252.747.252.747.000
630;BIQUINHAS;MG;68;23;91;252.747.252.747.252.000;747.252.747.252.747.000
158;ALTO PARAGUAI;MT;139;47;186;252.688.172.043.010.000;747.311.827.956.989.000
5269;TIMBAÈBA;PE;210;71;281;252.669.039.145.907.000;747.330.960.854.092.000
1508;CUMBE;SE;71;24;95;252.631.578.947.368.000;747.368.421.052.631.000
1192;CATARINA;CE;71;24;95;252.631.578.947.368.000;747.368.421.052.631.000
1225;CENTENµRIO;TO;71;24;95;252.631.578.947.368.000;747.368.421.052.631.000
1287;CIR÷ACO;RS;74;25;99;252.525.252.525.252.000;747.474.747.474.747.000
546;BARREIRAS DO PIAU÷;PI;74;25;99;252.525.252.525.252.000;747.474.747.474.747.000
4656;S«O DOMINGOS DO SUL;RS;74;25;99;252.525.252.525.252.000;747.474.747.474.747.000
4749;S«O JO«O DO PACU÷;MG;148;50;198;252.525.252.525.252.000;747.474.747.474.747.000
1596;DOIS LAJEADOS;RS;77;26;103;252.427.184.466.019.000;747.572.815.533.980.000
4011;POTIRAGUµ;BA;154;52;206;252.427.184.466.019.000;747.572.815.533.980.000
5010;SENADOR Sµ;CE;77;26;103;252.427.184.466.019.000;747.572.815.533.980.000
1180;CASTANHEIRAS;RO;157;53;210;252.380.952.380.952.000;747.619.047.619.047.000
1219;CEDRO;PE;80;27;107;252.336.448.598.130.000;747.663.551.401.869.000
2071;HERVAL D'OESTE;SC;160;54;214;252.336.448.598.130.000;747.663.551.401.869.000
4293;ROMARIA;MG;80;27;107;252.336.448.598.130.000;747.663.551.401.869.000
3654;PASSABêM;MG;80;27;107;252.336.448.598.130.000;747.663.551.401.869.000
2385;ITAPETIM;PE;80;27;107;252.336.448.598.130.000;747.663.551.401.869.000
5535;VIEIRAS;MG;80;27;107;252.336.448.598.130.000;747.663.551.401.869.000
76;AGUDO;RS;83;28;111;252.252.252.252.252.000;747.747.747.747.747.000
4923;S«O SEBASTI«O DA VARGEM ALEGRE;MG;83;28;111;252.252.252.252.252.000;747.747.747.747.747.000
369;AREALVA;SP;86;29;115;252.173.913.043.478.000;747.826.086.956.521.000
3779;PêROLA D'OESTE;PR;86;29;115;252.173.913.043.478.000;747.826.086.956.521.000
4142;REDENTORA;RS;89;30;119;252.100.840.336.134.000;747.899.159.663.865.000
682;BOM JESUS;RS;89;30;119;252.100.840.336.134.000;747.899.159.663.865.000
815;BURITIRAMA;BA;89;30;119;252.100.840.336.134.000;747.899.159.663.865.000
5397;UIBA÷;BA;89;30;119;252.100.840.336.134.000;747.899.159.663.865.000
3793;PIAT«;BA;92;31;123;252.032.520.325.203.000;747.967.479.674.796.000
2927;MARABµ PAULISTA;SP;92;31;123;252.032.520.325.203.000;747.967.479.674.796.000
5131;SUD MENNUCCI;SP;92;31;123;252.032.520.325.203.000;747.967.479.674.796.000
4625;S«O BENTO DO UNA;PE;184;62;246;252.032.520.325.203.000;747.967.479.674.796.000
1328;COMBINADO;TO;95;32;127;251.968.503.937.007.000;748.031.496.062.992.000
4907;S«O RAFAEL;RN;95;32;127;251.968.503.937.007.000;748.031.496.062.992.000
1612;DOM PEDRO DE ALC∂NTARA;RS;98;33;131;251.908.396.946.564.000;748.091.603.053.435.000
2876;MAIRI;BA;98;33;131;251.908.396.946.564.000;748.091.603.053.435.000
3539;PALESTINA DE GOIµS;GO;98;33;131;251.908.396.946.564.000;748.091.603.053.435.000
2254;IPOJUCA;PE;297;100;397;251.889.168.765.743.000;748.110.831.234.256.000
4552;SANTANA DOS MONTES;MG;101;34;135;251.851.851.851.851.000;748.148.148.148.148.000
37;AFONSO CLµUDIO;ES;208;70;278;251.798.561.151.079.000;748.201.438.848.920.000
827;CABACEIRAS DO PARAGUAÄU;BA;110;37;147;251.700.680.272.108.000;748.299.319.727.891.000
1010;CANABRAVA DO NORTE;MT;110;37;147;251.700.680.272.108.000;748.299.319.727.891.000
1586;DIVIN‡POLIS DO TOCANTINS;TO;110;37;147;251.700.680.272.108.000;748.299.319.727.891.000
1315;COLINAS DO SUL;GO;110;37;147;251.700.680.272.108.000;748.299.319.727.891.000
1740;EUGEN‡POLIS;MG;116;39;155;251.612.903.225.806.000;748.387.096.774.193.000
229;ANDARA÷;BA;122;41;163;251.533.742.331.288.000;748.466.257.668.711.000
3142;MONSENHOR GIL;PI;122;41;163;251.533.742.331.288.000;748.466.257.668.711.000
4549;SANTANA DO S«O FRANCISCO;SE;125;42;167;251.497.005.988.023.000;748.502.994.011.976.000
1194;CATAS ALTAS DA NORUEGA;MG;128;43;171;251.461.988.304.093.000;748.538.011.695.906.000
4523;SANTALUZ;BA;146;49;195;251.282.051.282.051.000;748.717.948.717.948.000
3447;OCARA;CE;146;49;195;251.282.051.282.051.000;748.717.948.717.948.000
1033;CAND‡I;PR;152;51;203;251.231.527.093.596.000;748.768.472.906.403.000
1615;DOMINGOS MARTINS;ES;173;58;231;251.082.251.082.251.000;748.917.748.917.748.000
1142;CARMO DO RIO VERDE;GO;179;60;239;251.046.025.104.602.000;748.953.974.895.397.000
4059;PRESIDENTE TANCREDO NEVES;BA;179;60;239;251.046.025.104.602.000;748.953.974.895.397.000
5572;VIT‡RIA DE SANTO ANT«O;PE;431;144;575;250.434.782.608.695.000;749.565.217.391.304.000
4047;PRESIDENTE JUSCELINO;MG;93;31;124;250.000.000.000.000.000;750.000.000.000.000.000
4133;REALEZA;PR;120;40;160;250.000.000.000.000.000;750.000.000.000.000.000
4093;QUEDAS DO IGUAÄU;PR;252;84;336;250.000.000.000.000.000;750.000.000.000.000.000
4175;RIACHO DE SANTANA;RN;54;18;72;250.000.000.000.000.000;750.000.000.000.000.000
4551;SANTANA DOS GARROTES;PB;60;20;80;250.000.000.000.000.000;750.000.000.000.000.000
4468;SANTA MARIA DO HERVAL;RS;84;28;112;250.000.000.000.000.000;750.000.000.000.000.000
4499;SANTA ROSA DE LIMA;SC;57;19;76;250.000.000.000.000.000;750.000.000.000.000.000
4371;SANG«O;SC;75;25;100;250.000.000.000.000.000;750.000.000.000.000.000
4363;SALVADOR DO SUL;RS;78;26;104;250.000.000.000.000.000;750.000.000.000.000.000
3444;NOVORIZONTE;MG;93;31;124;250.000.000.000.000.000;750.000.000.000.000.000
3703;PAVERAMA;RS;111;37;148;250.000.000.000.000.000;750.000.000.000.000.000
3627;PARATINGA;BA;159;53;212;250.000.000.000.000.000;750.000.000.000.000.000
3845;PINT‡POLIS;MG;165;55;220;250.000.000.000.000.000;750.000.000.000.000.000
3846;PIO IX;PI;78;26;104;250.000.000.000.000.000;750.000.000.000.000.000
3974;PORTO ALEGRE DO PIAU÷;PI;54;18;72;250.000.000.000.000.000;750.000.000.000.000.000
3946;PONTE ALTA DO TOCANTINS;TO;114;38;152;250.000.000.000.000.000;750.000.000.000.000.000
3911;POÄ«O;PE;102;34;136;250.000.000.000.000.000;750.000.000.000.000.000
3138;MONÄÂES;SP;54;18;72;250.000.000.000.000.000;750.000.000.000.000.000
3099;MIRADOR;PR;102;34;136;250.000.000.000.000.000;750.000.000.000.000.000
3033;MATO RICO;PR;84;28;112;250.000.000.000.000.000;750.000.000.000.000.000
2990;MARMELEIRO;PR;81;27;108;250.000.000.000.000.000;750.000.000.000.000.000
3379;NOVA PALMEIRA;PB;63;21;84;250.000.000.000.000.000;750.000.000.000.000.000
3311;NOVA AMêRICA DA COLINA;PR;96;32;128;250.000.000.000.000.000;750.000.000.000.000.000
3147;MONTALV∂NIA;MG;129;43;172;250.000.000.000.000.000;750.000.000.000.000.000
2430;ITATIBA DO SUL;RS;66;22;88;250.000.000.000.000.000;750.000.000.000.000.000
2556;JARDIM DO MULATO;PI;69;23;92;250.000.000.000.000.000;750.000.000.000.000.000
2538;JAPI;RN;99;33;132;250.000.000.000.000.000;750.000.000.000.000.000
2845;MACAMBIRA;SE;63;21;84;250.000.000.000.000.000;750.000.000.000.000.000
1001;CAMPOS LINDOS;TO;111;37;148;250.000.000.000.000.000;750.000.000.000.000.000
1039;CANHOTINHO;PE;111;37;148;250.000.000.000.000.000;750.000.000.000.000.000
888;CAIBI;SC;39;13;52;250.000.000.000.000.000;750.000.000.000.000.000
981;CAMPO GRANDE DO PIAU÷;PI;60;20;80;250.000.000.000.000.000;750.000.000.000.000.000
940;CAMOCIM DE S«O FêLIX;PE;93;31;124;250.000.000.000.000.000;750.000.000.000.000.000
753;BRASIL;BR;9;3;12;250.000.000.000.000.000;750.000.000.000.000.000
581;BELA VISTA DO PIAU÷;PI;42;14;56;250.000.000.000.000.000;750.000.000.000.000.000
604;BENEDITO NOVO;SC;111;37;148;250.000.000.000.000.000;750.000.000.000.000.000
197;AMATURµ;AM;171;57;228;250.000.000.000.000.000;750.000.000.000.000.000
209;AMPARO;PB;69;23;92;250.000.000.000.000.000;750.000.000.000.000.000
43;AGROL∂NDIA;SC;90;30;120;250.000.000.000.000.000;750.000.000.000.000.000
69;µGUAS DE SANTA BµRBARA;SP;147;49;196;250.000.000.000.000.000;750.000.000.000.000.000
130;ALPESTRE;RS;72;24;96;250.000.000.000.000.000;750.000.000.000.000.000
340;ARAPU«;PR;75;25;100;250.000.000.000.000.000;750.000.000.000.000.000
515;BARRA DE SANTA ROSA;PB;81;27;108;250.000.000.000.000.000;750.000.000.000.000.000
435;AURORA;SC;75;25;100;250.000.000.000.000.000;750.000.000.000.000.000
1575;DIRCEU ARCOVERDE;PI;66;22;88;250.000.000.000.000.000;750.000.000.000.000.000
1648;DURANDê;MG;87;29;116;250.000.000.000.000.000;750.000.000.000.000.000
1509;CUNHA;SP;162;54;216;250.000.000.000.000.000;750.000.000.000.000.000
1511;CUNHATA÷;SC;60;20;80;250.000.000.000.000.000;750.000.000.000.000.000
1555;DESCOBERTO;MG;147;49;196;250.000.000.000.000.000;750.000.000.000.000.000
1191;CATANDUVAS;SC;81;27;108;250.000.000.000.000.000;750.000.000.000.000.000
1149;CARNAUBAL;CE;63;21;84;250.000.000.000.000.000;750.000.000.000.000.000
1247;CEZARINA;GO;123;41;164;250.000.000.000.000.000;750.000.000.000.000.000
1281;CIDADE GAÈCHA;PR;84;28;112;250.000.000.000.000.000;750.000.000.000.000.000
1370;CONGONHAS DO NORTE;MG;117;39;156;250.000.000.000.000.000;750.000.000.000.000.000
1776;FELIPE GUERRA;RN;72;24;96;250.000.000.000.000.000;750.000.000.000.000.000
2050;GUATAMBÈ;SC;78;26;104;250.000.000.000.000.000;750.000.000.000.000.000
2036;GUARARµ;MG;138;46;184;250.000.000.000.000.000;750.000.000.000.000.000
2008;GUAPIRAMA;PR;114;38;152;250.000.000.000.000.000;750.000.000.000.000.000
4576;SANTO ANT‚NIO DE LISBOA;PI;57;19;76;250.000.000.000.000.000;750.000.000.000.000.000
5532;VICTOR GRAEFF;RS;66;22;88;250.000.000.000.000.000;750.000.000.000.000.000
5491;VARZEDO;BA;114;38;152;250.000.000.000.000.000;750.000.000.000.000.000
5398;UIRAMUT«;RR;117;39;156;250.000.000.000.000.000;750.000.000.000.000.000
5334;TRINDADE DO SUL;RS;57;19;76;250.000.000.000.000.000;750.000.000.000.000.000
5229;TEJUPµ;SP;108;36;144;250.000.000.000.000.000;750.000.000.000.000.000
4663;S«O FêLIX DO CORIBE;BA;102;34;136;250.000.000.000.000.000;750.000.000.000.000.000
4930;S«O SEBASTI«O DO PARA÷SO;MG;286;95;381;249.343.832.020.997.000;750.656.167.979.002.000
3040;MATRIZ DE CAMARAGIBE;AL;199;66;265;249.056.603.773.584.000;750.943.396.226.415.000
1334;CONCEIÄ«O DA APARECIDA;MG;175;58;233;248.927.038.626.609.000;751.072.961.373.390.000
5447;UTINGA;BA;160;53;213;248.826.291.079.812.000;751.173.708.920.187.000
5496;VENDA NOVA DO IMIGRANTE;ES;160;53;213;248.826.291.079.812.000;751.173.708.920.187.000
2134;IBITIRAMA;ES;124;41;165;248.484.848.484.848.000;751.515.151.515.151.000
3554;PALMEIRA DAS MISSÂES;RS;121;40;161;248.447.204.968.944.000;751.552.795.031.055.000
156;ALTO JEQUITIBµ;MG;118;39;157;248.407.643.312.101.000;751.592.356.687.898.000
4586;SANTO ANT‚NIO DO ITAMBê;MG;112;37;149;248.322.147.651.006.000;751.677.852.348.993.000
1857;FRANCISCO BADAR‡;MG;109;36;145;248.275.862.068.965.000;751.724.137.931.034.000
3736;PEDRIN‡POLIS;MG;106;35;141;248.226.950.354.609.000;751.773.049.645.390.000
4497;SANTA ROSA DA SERRA;MG;100;33;133;248.120.300.751.879.000;751.879.699.248.120.000
1935;GOIANDIRA;GO;100;33;133;248.120.300.751.879.000;751.879.699.248.120.000
5526;VICENTINA;MS;100;33;133;248.120.300.751.879.000;751.879.699.248.120.000
1426;C‡RREGO NOVO;MG;97;32;129;248.062.015.503.875.000;751.937.984.496.124.000
2135;IBITITµ;BA;94;31;125;248.000.000.000.000.000;752.000.000.000.000.000
1093;CARAµ;RS;94;31;125;248.000.000.000.000.000;752.000.000.000.000.000
2158;IGARAPê GRANDE;MA;91;30;121;247.933.884.297.520.000;752.066.115.702.479.000
3904;PLANALTO;PR;91;30;121;247.933.884.297.520.000;752.066.115.702.479.000
3618;PARANAPU«;SP;91;30;121;247.933.884.297.520.000;752.066.115.702.479.000
3365;NOVA M‡DICA;MG;88;29;117;247.863.247.863.247.000;752.136.752.136.752.000
3355;NOVA ITABERABA;SC;85;28;113;247.787.610.619.469.000;752.212.389.380.530.000
891;CAIÄARA DO NORTE;RN;85;28;113;247.787.610.619.469.000;752.212.389.380.530.000
743;BOTUVERµ;SC;85;28;113;247.787.610.619.469.000;752.212.389.380.530.000
560;BARROS CASSAL;RS;85;28;113;247.787.610.619.469.000;752.212.389.380.530.000
4851;S«O MAMEDE;PB;82;27;109;247.706.422.018.348.000;752.293.577.981.651.000
1792;FERREIROS;PE;79;26;105;247.619.047.619.047.000;752.380.952.380.952.000
2616;JOAQUIM TµVORA;PR;158;52;210;247.619.047.619.047.000;752.380.952.380.952.000
5345;TUCUNDUVA;RS;79;26;105;247.619.047.619.047.000;752.380.952.380.952.000
1582;DIVINOL∂NDIA;SP;155;51;206;247.572.815.533.980.000;752.427.184.466.019.000
4637;S«O CARLOS;SC;76;25;101;247.524.752.475.247.000;752.475.247.524.752.000
1851;FOZ DO JORD«O;PR;146;48;194;247.422.680.412.371.000;752.577.319.587.628.000
2187;IL‡POLIS;RS;73;24;97;247.422.680.412.371.000;752.577.319.587.628.000
207;AMORIN‡POLIS;GO;73;24;97;247.422.680.412.371.000;752.577.319.587.628.000
2728;LAGO«O;RS;73;24;97;247.422.680.412.371.000;752.577.319.587.628.000
4945;S«O VALENTIM;RS;73;24;97;247.422.680.412.371.000;752.577.319.587.628.000
1827;FONTE BOA;AM;283;93;376;247.340.425.531.914.000;752.659.574.468.085.000
6;ABA÷RA;BA;70;23;93;247.311.827.956.989.000;752.688.172.043.010.000
3388;NOVA ROMA;GO;70;23;93;247.311.827.956.989.000;752.688.172.043.010.000
4972;SARDOµ;MG;137;45;182;247.252.747.252.747.000;752.747.252.747.252.000
1215;CEARµ;CE;1815;596;2411;247.200.331.812.525.000;752.799.668.187.474.000
2217;INGAZEIRA;PE;67;22;89;247.191.011.235.955.000;752.808.988.764.044.000
2084;HUMAITµ;RS;67;22;89;247.191.011.235.955.000;752.808.988.764.044.000
2016;GUARACI;SP;134;44;178;247.191.011.235.955.000;752.808.988.764.044.000
612;BERILO;MG;134;44;178;247.191.011.235.955.000;752.808.988.764.044.000
875;CAETANOS;BA;134;44;178;247.191.011.235.955.000;752.808.988.764.044.000
3308;NOVA ALVORADA;RS;67;22;89;247.191.011.235.955.000;752.808.988.764.044.000
3976;PORTO AMAZONAS;PR;131;43;174;247.126.436.781.609.000;752.873.563.218.390.000
282;APICUM-AÄU;MA;195;64;259;247.104.247.104.247.000;752.895.752.895.752.000
3385;NOVA RAMADA;RS;64;21;85;247.058.823.529.411.000;752.941.176.470.588.000
3415;NOVO BARREIRO;RS;61;20;81;246.913.580.246.913.000;753.086.419.753.086.000
2806;LOGRADOURO;PB;61;20;81;246.913.580.246.913.000;753.086.419.753.086.000
4502;SANTA ROSA DO PIAU÷;PI;61;20;81;246.913.580.246.913.000;753.086.419.753.086.000
5258;TESOURO;MT;61;20;81;246.913.580.246.913.000;753.086.419.753.086.000
4862;S«O MIGUEL ARCANJO;SP;177;58;235;246.808.510.638.297.000;753.191.489.361.702.000
4550;SANTANA DO SERID‡;RN;58;19;77;246.753.246.753.246.000;753.246.753.246.753.000
3832;PINHAL«O;PR;116;38;154;246.753.246.753.246.000;753.246.753.246.753.000
2497;JACU÷;MG;116;38;154;246.753.246.753.246.000;753.246.753.246.753.000
5278;TIO HUGO;RS;58;19;77;246.753.246.753.246.000;753.246.753.246.753.000
4262;RIO PARDO DE MINAS;MG;168;55;223;246.636.771.300.448.000;753.363.228.699.551.000
4383;SANTA BµRBARA DO TUGÈRIO;MG;165;54;219;246.575.342.465.753.000;753.424.657.534.246.000
393;ARRAIAL;PI;55;18;73;246.575.342.465.753.000;753.424.657.534.246.000
1133;CARLOS GOMES;RS;55;18;73;246.575.342.465.753.000;753.424.657.534.246.000
1164;CASA GRANDE;MG;55;18;73;246.575.342.465.753.000;753.424.657.534.246.000
5038;SERRA DO SALITRE;MG;165;54;219;246.575.342.465.753.000;753.424.657.534.246.000
402;ARROIO TRINTA;SC;52;17;69;246.376.811.594.202.000;753.623.188.405.797.000
3313;NOVA ARAÄµ;RS;52;17;69;246.376.811.594.202.000;753.623.188.405.797.000
3081;MILTON BRAND«O;PI;52;17;69;246.376.811.594.202.000;753.623.188.405.797.000
1687;ENTRE-IJU÷S;RS;101;33;134;246.268.656.716.417.000;753.731.343.283.582.000
3178;MONTE SI«O;MG;193;63;256;246.093.750.000.000.000;753.906.250.000.000.000
1649;ECHAPOR«;SP;144;47;191;246.073.298.429.319.000;753.926.701.570.680.000
2722;LAGOA REAL;BA;92;30;122;245.901.639.344.262.000;754.098.360.655.737.000
3507;OURO VERDE;SC;46;15;61;245.901.639.344.262.000;754.098.360.655.737.000
4892;S«O PEDRO DA CIPA;MT;138;45;183;245.901.639.344.262.000;754.098.360.655.737.000
984;CAMPO LIMPO DE GOIµS;GO;135;44;179;245.810.055.865.921.000;754.189.944.134.078.000
1047;CANTAGALO;RJ;175;57;232;245.689.655.172.413.000;754.310.344.827.586.000
3685;PAULA C∂NDIDO;MG;175;57;232;245.689.655.172.413.000;754.310.344.827.586.000
3605;PARAMBU;CE;86;28;114;245.614.035.087.719.000;754.385.964.912.280.000
4233;RIO DO ANT‚NIO;BA;86;28;114;245.614.035.087.719.000;754.385.964.912.280.000
2274;IRA÷;RS;86;28;114;245.614.035.087.719.000;754.385.964.912.280.000
1861;FRANCISCO MACEDO;PI;43;14;57;245.614.035.087.719.000;754.385.964.912.280.000
4740;S«O JO«O DO CARIRI;PB;86;28;114;245.614.035.087.719.000;754.385.964.912.280.000
1759;FµTIMA;TO;83;27;110;245.454.545.454.545.000;754.545.454.545.454.000
955;CAMPINAÄU;GO;83;27;110;245.454.545.454.545.000;754.545.454.545.454.000
4251;RIO GRANDE DO SUL;RS;2180;709;2889;245.413.637.937.002.000;754.586.362.062.997.000
4025;PRAIA GRANDE;SC;80;26;106;245.283.018.867.924.000;754.716.981.132.075.000
3320;NOVA BRASIL∂NDIA;MT;80;26;106;245.283.018.867.924.000;754.716.981.132.075.000
3413;NOVO ALEGRE;TO;80;26;106;245.283.018.867.924.000;754.716.981.132.075.000
386;ARIRANHA DO IVA÷;PR;80;26;106;245.283.018.867.924.000;754.716.981.132.075.000
4756;S«O JO«O DO SABUGI;RN;80;26;106;245.283.018.867.924.000;754.716.981.132.075.000
4914;S«O ROQUE DE MINAS;MG;120;39;159;245.283.018.867.924.000;754.716.981.132.075.000
1468;CRISTµLIA;MG;77;25;102;245.098.039.215.686.000;754.901.960.784.313.000
1799;FILADêLFIA;BA;151;49;200;245.000.000.000.000.000;755.000.000.000.000.000
691;BOM JESUS DO GALHO;MG;151;49;200;245.000.000.000.000.000;755.000.000.000.000.000
430;AUGUSTO PESTANA;RS;74;24;98;244.897.959.183.673.000;755.102.040.816.326.000
2238;IP“;RS;74;24;98;244.897.959.183.673.000;755.102.040.816.326.000
4415;SANTA CRUZ DOS MILAGRES;PI;74;24;98;244.897.959.183.673.000;755.102.040.816.326.000
4442;SANTA IZABEL DO OESTE;PR;74;24;98;244.897.959.183.673.000;755.102.040.816.326.000
3816;PIMENTEIRAS;PI;74;24;98;244.897.959.183.673.000;755.102.040.816.326.000
3849;PIQUET CARNEIRO;CE;74;24;98;244.897.959.183.673.000;755.102.040.816.326.000
5056;SERRINHA;RN;74;24;98;244.897.959.183.673.000;755.102.040.816.326.000
3425;NOVO HORIZONTE DO OESTE;RO;145;47;192;244.791.666.666.666.000;755.208.333.333.333.000
2391;ITAPICURU;BA;145;47;192;244.791.666.666.666.000;755.208.333.333.333.000
1570;DIOGO DE VASCONCELOS;MG;108;35;143;244.755.244.755.244.000;755.244.755.244.755.000
4960;SAPEAÄU;BA;179;58;237;244.725.738.396.624.000;755.274.261.603.375.000
1378;CONSTANTINA;RS;71;23;94;244.680.851.063.829.000;755.319.148.936.170.000
328;ARAME;MA;142;46;188;244.680.851.063.829.000;755.319.148.936.170.000
3422;NOVO HORIZONTE;BA;71;23;94;244.680.851.063.829.000;755.319.148.936.170.000
2953;MARCELINO RAMOS;RS;71;23;94;244.680.851.063.829.000;755.319.148.936.170.000
4581;SANTO ANT‚NIO DO AVENTUREIRO;MG;71;23;94;244.680.851.063.829.000;755.319.148.936.170.000
4929;S«O SEBASTI«O DO OESTE;MG;142;46;188;244.680.851.063.829.000;755.319.148.936.170.000
5084;SILVEIR∂NIA;MG;71;23;94;244.680.851.063.829.000;755.319.148.936.170.000
5421;UNISTALDA;RS;71;23;94;244.680.851.063.829.000;755.319.148.936.170.000
177;ALVINL∂NDIA;SP;105;34;139;244.604.316.546.762.000;755.395.683.453.237.000
2871;MAGALH«ES BARATA;PA;139;45;184;244.565.217.391.304.000;755.434.782.608.695.000
3756;PENAFORTE;CE;68;22;90;244.444.444.444.444.000;755.555.555.555.555.000
528;BARRA DO MENDES;BA;102;33;135;244.444.444.444.444.000;755.555.555.555.555.000
5065;SERT«O;RS;68;22;90;244.444.444.444.444.000;755.555.555.555.555.000
5599;XEXêU;PE;133;43;176;244.318.181.818.181.000;755.681.818.181.818.000
128;ALO∂NDIA;GO;65;21;86;244.186.046.511.627.000;755.813.953.488.372.000
1685;ENTRE RIOS DO OESTE;PR;65;21;86;244.186.046.511.627.000;755.813.953.488.372.000
4338;SALGADINHO;PE;65;21;86;244.186.046.511.627.000;755.813.953.488.372.000
3158;MONTE ALEGRE DOS CAMPOS;RS;65;21;86;244.186.046.511.627.000;755.813.953.488.372.000
3200;MORRINHOS DO SUL;RS;65;21;86;244.186.046.511.627.000;755.813.953.488.372.000
2856;MACHADINHO;RS;65;21;86;244.186.046.511.627.000;755.813.953.488.372.000
5519;VIADUTOS;RS;65;21;86;244.186.046.511.627.000;755.813.953.488.372.000
5007;SENADOR MODESTINO GONÄALVES;MG;130;42;172;244.186.046.511.627.000;755.813.953.488.372.000
4727;S«O JO«O DA SERRA;PI;65;21;86;244.186.046.511.627.000;755.813.953.488.372.000
3590;PARAGUAÄU;MG;226;73;299;244.147.157.190.635.000;755.852.842.809.364.000
1789;FERN«O;SP;96;31;127;244.094.488.188.976.000;755.905.511.811.023.000
972;CAMPO DO BRITO;SE;127;41;168;244.047.619.047.619.000;755.952.380.952.380.000
2883;MAJOR VIEIRA;SC;127;41;168;244.047.619.047.619.000;755.952.380.952.380.000
2843;MAÄAMBARA;RS;31;10;41;243.902.439.024.390.000;756.097.560.975.609.000
3513;OUVIDOR;GO;93;30;123;243.902.439.024.390.000;756.097.560.975.609.000
506;BARCELONA;RN;62;20;82;243.902.439.024.390.000;756.097.560.975.609.000
5593;XAMBR“;PR;93;30;123;243.902.439.024.390.000;756.097.560.975.609.000
3853;PIRACEMA;MG;121;39;160;243.750.000.000.000.000;756.250.000.000.000.000
3989;PORTO FIRME;MG;121;39;160;243.750.000.000.000.000;756.250.000.000.000.000
2068;HELI‡POLIS;BA;90;29;119;243.697.478.991.596.000;756.302.521.008.403.000
5291;TOMAZINA;PR;90;29;119;243.697.478.991.596.000;756.302.521.008.403.000
2273;IRACEMINHA;SC;59;19;78;243.589.743.589.743.000;756.410.256.410.256.000
3649;PASSA E FICA;RN;59;19;78;243.589.743.589.743.000;756.410.256.410.256.000
2766;LAVANDEIRA;TO;59;19;78;243.589.743.589.743.000;756.410.256.410.256.000
2426;ITATI;RS;59;19;78;243.589.743.589.743.000;756.410.256.410.256.000
4291;ROLANTE;RS;146;47;193;243.523.316.062.176.000;756.476.683.937.823.000
2655;JUNDIA÷ DO SUL;PR;87;28;115;243.478.260.869.565.000;756.521.739.130.434.000
1954;GOVERNADOR CELSO RAMOS;SC;174;56;230;243.478.260.869.565.000;756.521.739.130.434.000
1391;CORDEIROS;BA;84;27;111;243.243.243.243.243.000;756.756.756.756.756.000
444;AVELINO LOPES;PI;84;27;111;243.243.243.243.243.000;756.756.756.756.756.000
2628;JOSê RAYDAN;MG;140;45;185;243.243.243.243.243.000;756.756.756.756.756.000
3229;MULUNGU;CE;112;36;148;243.243.243.243.243.000;756.756.756.756.756.000
3396;NOVA SANTA ROSA;PR;84;27;111;243.243.243.243.243.000;756.756.756.756.756.000
3655;PASSAGEM;PB;56;18;74;243.243.243.243.243.000;756.756.756.756.756.000
26;ACRE;AC;1133;364;1497;243.152.972.611.890.000;756.847.027.388.109.000
866;CACIMBAS;PB;81;26;107;242.990.654.205.607.000;757.009.345.794.392.000
1699;ERVAL VELHO;SC;81;26;107;242.990.654.205.607.000;757.009.345.794.392.000
4038;PRESIDENTE BERNARDES;MG;81;26;107;242.990.654.205.607.000;757.009.345.794.392.000
3764;PEQUI;MG;134;43;177;242.937.853.107.344.000;757.062.146.892.655.000
4039;PRESIDENTE CASTELO BRANCO;SC;53;17;70;242.857.142.857.142.000;757.142.857.142.857.000
4808;S«O JOSê DO INHACORµ;RS;53;17;70;242.857.142.857.142.000;757.142.857.142.857.000
5351;TUNAS;RS;78;25;103;242.718.446.601.941.000;757.281.553.398.058.000
5377;TURVO;SC;78;25;103;242.718.446.601.941.000;757.281.553.398.058.000
4212;RIO AZUL;PR;178;57;235;242.553.191.489.361.000;757.446.808.510.638.000
4237;RIO DO PIRES;BA;75;24;99;242.424.242.424.242.000;757.575.757.575.757.000
860;CACHOEIRINHA;TO;100;32;132;242.424.242.424.242.000;757.575.757.575.757.000
263;ANT‚NIO CARLOS;SC;75;24;99;242.424.242.424.242.000;757.575.757.575.757.000
4815;S«O JOSê DO PIAU÷;PI;50;16;66;242.424.242.424.242.000;757.575.757.575.757.000
1407;CORONEL DOMINGOS SOARES;PR;122;39;161;242.236.024.844.720.000;757.763.975.155.279.000
4240;RIO DOCE;MG;122;39;161;242.236.024.844.720.000;757.763.975.155.279.000
4605;SANTO EXPEDITO;SP;97;31;128;242.187.500.000.000.000;757.812.500.000.000.000
4068;PRINCESA;SC;72;23;95;242.105.263.157.894.000;757.894.736.842.105.000
2894;MAMONAS;MG;72;23;95;242.105.263.157.894.000;757.894.736.842.105.000
3088;MINAS NOVAS;MG;216;69;285;242.105.263.157.894.000;757.894.736.842.105.000
1644;DUERê;TO;72;23;95;242.105.263.157.894.000;757.894.736.842.105.000
1581;DIVINO DE S«O LOURENÄO;ES;144;46;190;242.105.263.157.894.000;757.894.736.842.105.000
1125;CARIRê;CE;72;23;95;242.105.263.157.894.000;757.894.736.842.105.000
909;CALÄADO;PE;94;30;124;241.935.483.870.967.000;758.064.516.129.032.000
339;ARAPUµ;MG;94;30;124;241.935.483.870.967.000;758.064.516.129.032.000
1199;CATOLê DO ROCHA;PB;94;30;124;241.935.483.870.967.000;758.064.516.129.032.000
2892;MAMBA÷;GO;94;30;124;241.935.483.870.967.000;758.064.516.129.032.000
4443;SANTA JULIANA;MG;141;45;186;241.935.483.870.967.000;758.064.516.129.032.000
5266;TIGRINHOS;SC;47;15;62;241.935.483.870.967.000;758.064.516.129.032.000
291;AQUIDAB«;SE;163;52;215;241.860.465.116.279.000;758.139.534.883.720.000
1691;EREBANGO;RS;69;22;91;241.758.241.758.241.000;758.241.758.241.758.000
3430;NOVO MACHADO;RS;69;22;91;241.758.241.758.241.000;758.241.758.241.758.000
2897;MANA÷RA;PB;69;22;91;241.758.241.758.241.000;758.241.758.241.758.000
2284;IRATI;SC;69;22;91;241.758.241.758.241.000;758.241.758.241.758.000
721;BONITO;PA;160;51;211;241.706.161.137.440.000;758.293.838.862.559.000
1986;GUABIRUBA;SC;113;36;149;241.610.738.255.033.000;758.389.261.744.966.000
1007;CANA VERDE;MG;135;43;178;241.573.033.707.865.000;758.426.966.292.134.000
1081;CAPIT«O DE CAMPOS;PI;88;28;116;241.379.310.344.827.000;758.620.689.655.172.000
975;CAMPO ER“;SC;88;28;116;241.379.310.344.827.000;758.620.689.655.172.000
1905;GAURAMA;RS;66;21;87;241.379.310.344.827.000;758.620.689.655.172.000
1711;ESPIG«O ALTO DO IGUAÄU;PR;88;28;116;241.379.310.344.827.000;758.620.689.655.172.000
2796;LIND‡IA DO SUL;SC;66;21;87;241.379.310.344.827.000;758.620.689.655.172.000
3314;NOVA AURORA;GO;66;21;87;241.379.310.344.827.000;758.620.689.655.172.000
1614;DOM VIÄOSO;MG;107;34;141;241.134.751.773.049.000;758.865.248.226.950.000
3389;NOVA ROMA DO SUL;RS;63;20;83;240.963.855.421.686.000;759.036.144.578.313.000
2970;MARIANO MORO;RS;63;20;83;240.963.855.421.686.000;759.036.144.578.313.000
1460;CRIS‡POLIS;BA;104;33;137;240.875.912.408.759.000;759.124.087.591.240.000
3318;NOVA BELêM;MG;82;26;108;240.740.740.740.740.000;759.259.259.259.259.000
3730;PEDRAS GRANDES;SC;82;26;108;240.740.740.740.740.000;759.259.259.259.259.000
4596;SANTO ANT‚NIO DO RETIRO;MG;123;39;162;240.740.740.740.740.000;759.259.259.259.259.000
5451;VALE DO PARA÷SO;RO;123;39;162;240.740.740.740.740.000;759.259.259.259.259.000
788;BROCHIER;RS;101;32;133;240.601.503.759.398.000;759.398.496.240.601.000
1045;CANSANÄ«O;BA;180;57;237;240.506.329.113.924.000;759.493.670.886.075.000
1626;DORES‡POLIS;MG;60;19;79;240.506.329.113.924.000;759.493.670.886.075.000
1383;COQUEIRO BAIXO;RS;60;19;79;240.506.329.113.924.000;759.493.670.886.075.000
1329;COMENDADOR GOMES;MG;60;19;79;240.506.329.113.924.000;759.493.670.886.075.000
3738;PEDRO ALEXANDRE;BA;120;38;158;240.506.329.113.924.000;759.493.670.886.075.000
4572;SANTO ANT‚NIO DA PLATINA;PR;259;82;341;240.469.208.211.143.000;759.530.791.788.856.000
4536;SANTANA DO DESERTO;MG;158;50;208;240.384.615.384.615.000;759.615.384.615.384.000
4559;SANTO AFONSO;MT;79;25;104;240.384.615.384.615.000;759.615.384.615.384.000
2717;LAGOA FORMOSA;MG;79;25;104;240.384.615.384.615.000;759.615.384.615.384.000
763;BRAS‡POLIS;MG;79;25;104;240.384.615.384.615.000;759.615.384.615.384.000
5181;TANQUE NOVO;BA;98;31;129;240.310.077.519.379.000;759.689.922.480.620.000
4776;S«O JOSê DA COROA GRANDE;PE;253;80;333;240.240.240.240.240.000;759.759.759.759.759.000
1098;CARA÷;MG;155;49;204;240.196.078.431.372.000;759.803.921.568.627.000
829;CABECEIRAS;GO;114;36;150;240.000.000.000.000.000;760.000.000.000.000.000
1505;CUMARI;GO;76;24;100;240.000.000.000.000.000;760.000.000.000.000.000
1813;FLORES DO PIAU÷;PI;76;24;100;240.000.000.000.000.000;760.000.000.000.000.000
4447;SANTA LUZ;PI;57;18;75;240.000.000.000.000.000;760.000.000.000.000.000
4238;RIO DO PRADO;MG;76;24;100;240.000.000.000.000.000;760.000.000.000.000.000
4665;S«O FêLIX DO TOCANTINS;TO;76;24;100;240.000.000.000.000.000;760.000.000.000.000.000
686;BOM JESUS DA SERRA;BA;130;41;171;239.766.081.871.345.000;760.233.918.128.654.000
4804;S«O JOSê DO EGITO;PE;130;41;171;239.766.081.871.345.000;760.233.918.128.654.000
2622;JORD«O;AC;111;35;146;239.726.027.397.260.000;760.273.972.602.739.000
5283;TOCANT÷NIA;TO;111;35;146;239.726.027.397.260.000;760.273.972.602.739.000
2817;LUCIAN‡POLIS;SP;73;23;96;239.583.333.333.333.000;760.416.666.666.666.000
2561;JARI;RS;73;23;96;239.583.333.333.333.000;760.416.666.666.666.000
4206;RIBEIRO GONÄALVES;PI;73;23;96;239.583.333.333.333.000;760.416.666.666.666.000
3570;PALMITINHO;RS;73;23;96;239.583.333.333.333.000;760.416.666.666.666.000
4980;SAUDADES;SC;73;23;96;239.583.333.333.333.000;760.416.666.666.666.000
4884;S«O PAULO;SP;10371;3267;13638;239.551.253.849.538.000;760.448.746.150.461.000
3916;POÄO DAS ANTAS;RS;54;17;71;239.436.619.718.309.000;760.563.380.281.690.000
1698;ERVAL SECO;RS;108;34;142;239.436.619.718.309.000;760.563.380.281.690.000
4900;S«O PEDRO DO PARANµ;PR;54;17;71;239.436.619.718.309.000;760.563.380.281.690.000
1769;FEIRA DA MATA;BA;89;28;117;239.316.239.316.239.000;760.683.760.683.760.000
231;ANDORINHA;BA;178;56;234;239.316.239.316.239.000;760.683.760.683.760.000
3002;MASCOTE;BA;194;61;255;239.215.686.274.509.000;760.784.313.725.490.000
3051;MAXIMILIANO DE ALMEIDA;RS;70;22;92;239.130.434.782.608.000;760.869.565.217.391.000
3891;PITANGUEIRAS;PR;70;22;92;239.130.434.782.608.000;760.869.565.217.391.000
3441;NOVO TIRADENTES;RS;70;22;92;239.130.434.782.608.000;760.869.565.217.391.000
4116;QUIXABEIRA;BA;70;22;92;239.130.434.782.608.000;760.869.565.217.391.000
50;µGUA BRANCA;PB;70;22;92;239.130.434.782.608.000;760.869.565.217.391.000
125;ALMINO AFONSO;RN;70;22;92;239.130.434.782.608.000;760.869.565.217.391.000
2109;IBICARê;SC;70;22;92;239.130.434.782.608.000;760.869.565.217.391.000
1585;DIVIN‡POLIS DE GOIµS;GO;105;33;138;239.130.434.782.608.000;760.869.565.217.391.000
1224;CENTENµRIO;RS;70;22;92;239.130.434.782.608.000;760.869.565.217.391.000
4355;SALTO DO CêU;MT;86;27;113;238.938.053.097.345.000;761.061.946.902.654.000
4519;SANTA TEREZINHA DO PROGRESSO;SC;102;32;134;238.805.970.149.253.000;761.194.029.850.746.000
4035;PRATINHA;MG;102;32;134;238.805.970.149.253.000;761.194.029.850.746.000
882;CAFEL∂NDIA;PR;118;37;155;238.709.677.419.354.000;761.290.322.580.645.000
2018;GUARACIABA;MG;134;42;176;238.636.363.636.363.000;761.363.636.363.636.000
4330;SAGRADA FAM÷LIA;RS;67;21;88;238.636.363.636.363.000;761.363.636.363.636.000
3459;OLHO D'µGUA DO PIAU÷;PI;67;21;88;238.636.363.636.363.000;761.363.636.363.636.000
3843;PINTADAS;BA;67;21;88;238.636.363.636.363.000;761.363.636.363.636.000
2944;MARATµ;RS;83;26;109;238.532.110.091.743.000;761.467.889.908.256.000
1924;GL‡RIA;BA;99;31;130;238.461.538.461.538.000;761.538.461.538.461.000
323;ARAGUATINS;TO;214;67;281;238.434.163.701.067.000;761.565.836.298.932.000
5477;VARJ«O DE MINAS;MG;115;36;151;238.410.596.026.490.000;761.589.403.973.509.000
5260;THEOBROMA;RO;131;41;172;238.372.093.023.255.000;761.627.906.976.744.000
4333;SALDANHA MARINHO;RS;64;20;84;238.095.238.095.238.000;761.904.761.904.761.000
2030;GUARANIAÄU;PR;141;44;185;237.837.837.837.837.000;762.162.162.162.162.000
1480;CRUCIL∂NDIA;MG;141;44;185;237.837.837.837.837.000;762.162.162.162.162.000
2480;JABOTI;PR;77;24;101;237.623.762.376.237.000;762.376.237.623.762.000
5133;SULINA;PR;77;24;101;237.623.762.376.237.000;762.376.237.623.762.000
3322;NOVA BRêSCIA;RS;61;19;80;237.500.000.000.000.000;762.500.000.000.000.000
5186;TAPEJARA;PR;167;52;219;237.442.922.374.429.000;762.557.077.625.570.000
2955;MARCION÷LIO SOUZA;BA;106;33;139;237.410.071.942.446.000;762.589.928.057.553.000
494;BAR«O DE COTEGIPE;RS;90;28;118;237.288.135.593.220.000;762.711.864.406.779.000
2020;GUARACIAMA;MG;119;37;156;237.179.487.179.487.000;762.820.512.820.512.000
3295;NORMANDIA;RR;119;37;156;237.179.487.179.487.000;762.820.512.820.512.000
3141;MONJOLOS;MG;103;32;135;237.037.037.037.037.000;762.962.962.962.962.000
2329;ITA÷BA;PE;161;50;211;236.966.824.644.549.000;763.033.175.355.450.000
1113;CARBONITA;MG;100;31;131;236.641.221.374.045.000;763.358.778.625.954.000
1083;CAPIT«O GERVµSIO OLIVEIRA;PI;71;22;93;236.559.139.784.946.000;763.440.860.215.053.000
1377;CONSOLAÄ«O;MG;71;22;93;236.559.139.784.946.000;763.440.860.215.053.000
4423;SANTA FILOMENA;PI;71;22;93;236.559.139.784.946.000;763.440.860.215.053.000
5331;TREZE T÷LIAS;SC;71;22;93;236.559.139.784.946.000;763.440.860.215.053.000
4687;S«O FRANCISCO DO PIAU÷;PI;71;22;93;236.559.139.784.946.000;763.440.860.215.053.000
4004;PORTO VIT‡RIA;PR;84;26;110;236.363.636.363.636.000;763.636.363.636.363.000
3427;NOVO ITACOLOMI;PR;126;39;165;236.363.636.363.636.000;763.636.363.636.363.000
2042;GUARDA-MOR;MG;84;26;110;236.363.636.363.636.000;763.636.363.636.363.000
268;ANTONIO OLINTO;PR;97;30;127;236.220.472.440.944.000;763.779.527.559.055.000
3795;PIAU÷;PI;822;254;1076;236.059.479.553.903.000;763.940.520.446.096.000
3992;PORTO LUCENA;RS;68;21;89;235.955.056.179.775.000;764.044.943.820.224.000
1392;CORDILHEIRA ALTA;SC;68;21;89;235.955.056.179.775.000;764.044.943.820.224.000
2860;MACIEIRA;SC;81;25;106;235.849.056.603.773.000;764.150.943.396.226.000
2532;JANI‡POLIS;PR;94;29;123;235.772.357.723.577.000;764.227.642.276.422.000
4162;RETIROL∂NDIA;BA;94;29;123;235.772.357.723.577.000;764.227.642.276.422.000
1930;GODOY MOREIRA;PR;107;33;140;235.714.285.714.285.000;764.285.714.285.714.000
1877;FRONTEIRA DOS VALES;MG;120;37;157;235.668.789.808.917.000;764.331.210.191.082.000
3609;PARANµ;PR;2375;731;3106;235.350.933.676.754.000;764.649.066.323.245.000
3536;PAJEÈ DO PIAU÷;PI;52;16;68;235.294.117.647.058.000;764.705.882.352.941.000
2484;JAÄAN«;RN;78;24;102;235.294.117.647.058.000;764.705.882.352.941.000
3029;MATO GROSSO;MT;936;288;1224;235.294.117.647.058.000;764.705.882.352.941.000
244;ANGICOS;RN;91;28;119;235.294.117.647.058.000;764.705.882.352.941.000
1109;CARAÈBAS;PB;65;20;85;235.294.117.647.058.000;764.705.882.352.941.000
656;BOA VISTA DO SUL;RS;52;16;68;235.294.117.647.058.000;764.705.882.352.941.000
651;BOA VISTA DO BURICµ;RS;65;20;85;235.294.117.647.058.000;764.705.882.352.941.000
5153;TACARATU;PE;130;40;170;235.294.117.647.058.000;764.705.882.352.941.000
4958;S«O VICENTE FêRRER;PE;65;20;85;235.294.117.647.058.000;764.705.882.352.941.000
5583;WALL FERRAZ;PI;65;20;85;235.294.117.647.058.000;764.705.882.352.941.000
5564;VISTA ALEGRE DO PRATA;RS;52;16;68;235.294.117.647.058.000;764.705.882.352.941.000
1143;CARMOL∂NDIA;TO;114;35;149;234.899.328.859.060.000;765.100.671.140.939.000
4406;SANTA CRUZ DE MONTE CASTELO;PR;114;35;149;234.899.328.859.060.000;765.100.671.140.939.000
5383;UBA÷;MG;114;35;149;234.899.328.859.060.000;765.100.671.140.939.000
928;CAMARAGIBE;PE;544;167;711;234.880.450.070.323.000;765.119.549.929.676.000
1785;FERNANDO FALC«O;MA;101;31;132;234.848.484.848.484.000;765.151.515.151.515.000
1415;CORONEL MARTINS;SC;88;27;115;234.782.608.695.652.000;765.217.391.304.347.000
4045;PRESIDENTE GETÈLIO;SC;124;38;162;234.567.901.234.567.000;765.432.098.765.432.000
2491;JACI;SP;124;38;162;234.567.901.234.567.000;765.432.098.765.432.000
1256;CHAPADA DO NORTE;MG;98;30;128;234.375.000.000.000.000;765.625.000.000.000.000
116;ALFREDO WAGNER;SC;85;26;111;234.234.234.234.234.000;765.765.765.765.765.000
1735;ESTRELA D'OESTE;SP;108;33;141;234.042.553.191.489.000;765.957.446.808.510.000
2880;MAJOR GERCINO;SC;72;22;94;234.042.553.191.489.000;765.957.446.808.510.000
4173;RIACHO DAS ALMAS;PE;144;44;188;234.042.553.191.489.000;765.957.446.808.510.000
4730;S«O JO«O D'ALIANÄA;GO;180;55;235;234.042.553.191.489.000;765.957.446.808.510.000
742;BOTUPOR«;BA;95;29;124;233.870.967.741.935.000;766.129.032.258.064.000
3121;MISS«O VELHA;CE;105;32;137;233.576.642.335.766.000;766.423.357.664.233.000
462;BAIXA GRANDE;BA;138;42;180;233.333.333.333.333.000;766.666.666.666.666.000
1241;CERRO GRANDE;RS;69;21;90;233.333.333.333.333.000;766.666.666.666.666.000
1702;ESMERALDA;RS;69;21;90;233.333.333.333.333.000;766.666.666.666.666.000
4249;RIO GRANDE DO NORTE;RN;691;210;901;233.074.361.820.199.000;766.925.638.179.800.000
2310;ITACAMBIRA;MG;112;34;146;232.876.712.328.767.000;767.123.287.671.232.000
1563;DIAMANTE DO SUL;PR;112;34;146;232.876.712.328.767.000;767.123.287.671.232.000
4747;S«O JO«O DO OESTE;SC;56;17;73;232.876.712.328.767.000;767.123.287.671.232.000
1162;CARVALHOS;MG;89;27;116;232.758.620.689.655.000;767.241.379.310.344.000
2993;MARQUINHO;PR;89;27;116;232.758.620.689.655.000;767.241.379.310.344.000
676;BOM JARDIM DA SERRA;SC;66;20;86;232.558.139.534.883.000;767.441.860.465.116.000
5073;SETUBINHA;MG;165;50;215;232.558.139.534.883.000;767.441.860.465.116.000
4243;RIO DOS ÷NDIOS;RS;76;23;99;232.323.232.323.232.000;767.676.767.676.767.000
5567;VITOR MEIRELES;SC;76;23;99;232.323.232.323.232.000;767.676.767.676.767.000
2885;MALHADA;BA;119;36;155;232.258.064.516.129.000;767.741.935.483.870.000
5240;TEOL∂NDIA;BA;129;39;168;232.142.857.142.857.000;767.857.142.857.142.000
4190;RIBEIR«O;PE;242;73;315;231.746.031.746.031.000;768.253.968.253.968.000
542;BARRAC«O;RS;63;19;82;231.707.317.073.170.000;768.292.682.926.829.000
1805;FLOR DO SERT«O;SC;63;19;82;231.707.317.073.170.000;768.292.682.926.829.000
2195;IMBUIA;SC;73;22;95;231.578.947.368.421.000;768.421.052.631.578.000
1272;CHOPINZINHO;PR;73;22;95;231.578.947.368.421.000;768.421.052.631.578.000
1339;CONCEIÄ«O DAS PEDRAS;MG;73;22;95;231.578.947.368.421.000;768.421.052.631.578.000
485;BANDEIRANTE;SC;73;22;95;231.578.947.368.421.000;768.421.052.631.578.000
1221;CEDRO DE S«O JO«O;SE;83;25;108;231.481.481.481.481.000;768.518.518.518.518.000
2136;IBITIÈRA DE MINAS;MG;93;28;121;231.404.958.677.685.000;768.595.041.322.314.000
1288;CLARAVAL;MG;133;40;173;231.213.872.832.369.000;768.786.127.167.630.000
2350;ITAMARATI;AM;133;40;173;231.213.872.832.369.000;768.786.127.167.630.000
2411;ITAPUCA;RS;70;21;91;230.769.230.769.230.000;769.230.769.230.769.000
3337;NOVA ESPERANÄA DO SUDOESTE;PR;70;21;91;230.769.230.769.230.000;769.230.769.230.769.000
4277;RIQUEZA;SC;80;24;104;230.769.230.769.230.000;769.230.769.230.769.000
4351;SALTINHO;SC;70;21;91;230.769.230.769.230.000;769.230.769.230.769.000
3445;NUPORANGA;SP;100;30;130;230.769.230.769.230.000;769.230.769.230.769.000
2132;IBITIARA;BA;100;30;130;230.769.230.769.230.000;769.230.769.230.769.000
1069;CAPELA NOVA;MG;90;27;117;230.769.230.769.230.000;769.230.769.230.769.000
5193;TAPIRA÷;MG;100;30;130;230.769.230.769.230.000;769.230.769.230.769.000
5449;VALE DE S«O DOMINGOS;MT;70;21;91;230.769.230.769.230.000;769.230.769.230.769.000
2687;LAGAMAR;MG;117;35;152;230.263.157.894.736.000;769.736.842.105.263.000
1595;DOIS IRM«OS DO TOCANTINS;TO;97;29;126;230.158.730.158.730.000;769.841.269.841.269.000
4778;S«O JOSê DA LAJE;AL;164;49;213;230.046.948.356.807.000;769.953.051.643.192.000
1969;GRAJAÈ;MA;318;95;413;230.024.213.075.060.000;769.975.786.924.939.000
2146;ICHU;BA;77;23;100;230.000.000.000.000.000;770.000.000.000.000.000
1452;COXIXOLA;PB;67;20;87;229.885.057.471.264.000;770.114.942.528.735.000
1244;CERRO NEGRO;SC;67;20;87;229.885.057.471.264.000;770.114.942.528.735.000
4435;SANTA IN“S;PR;67;20;87;229.885.057.471.264.000;770.114.942.528.735.000
4946;S«O VALENTIM DO SUL;RS;67;20;87;229.885.057.471.264.000;770.114.942.528.735.000
2011;GUAPOREMA;PR;57;17;74;229.729.729.729.729.000;770.270.270.270.270.000
5458;VALENTE;BA;104;31;135;229.629.629.629.629.000;770.370.370.370.370.000
2089;IAÄU;BA;188;56;244;229.508.196.721.311.000;770.491.803.278.688.000
1638;DOUTOR ULYSSES;PR;94;28;122;229.508.196.721.311.000;770.491.803.278.688.000
1674;ENêAS MARQUES;PR;84;25;109;229.357.798.165.137.000;770.642.201.834.862.000
4374;SANTA ALBERTINA;SP;74;22;96;229.166.666.666.666.000;770.833.333.333.333.000
2665;JUREMA;PE;74;22;96;229.166.666.666.666.000;770.833.333.333.333.000
2641;JUCATI;PE;74;22;96;229.166.666.666.666.000;770.833.333.333.333.000
2398;ITAPIRATINS;TO;74;22;96;229.166.666.666.666.000;770.833.333.333.333.000
4373;SANTA ADêLIA;SP;101;30;131;229.007.633.587.786.000;770.992.366.412.213.000
3709;PEDRA;PE;81;24;105;228.571.428.571.428.000;771.428.571.428.571.000
602;BENEDITINOS;PI;108;32;140;228.571.428.571.428.000;771.428.571.428.571.000
240;ANGELINA;SC;81;24;105;228.571.428.571.428.000;771.428.571.428.571.000
257;ANTAS;BA;81;24;105;228.571.428.571.428.000;771.428.571.428.571.000
5417;UNI«O DO SUL;MT;81;24;105;228.571.428.571.428.000;771.428.571.428.571.000
1625;DORES DO TURVO;MG;142;42;184;228.260.869.565.217.000;771.739.130.434.782.000
3915;POÄO DANTAS;PB;44;13;57;228.070.175.438.596.000;771.929.824.561.403.000
3327;NOVA CANDELµRIA;RS;44;13;57;228.070.175.438.596.000;771.929.824.561.403.000
3593;PARA÷BA;PB;1060;313;1373;227.967.953.386.744.000;772.032.046.613.255.000
648;BOA VISTA;PB;105;31;136;227.941.176.470.588.000;772.058.823.529.411.000
5571;VIT‡RIA DAS MISSÂES;RS;61;18;79;227.848.101.265.822.000;772.151.898.734.177.000
5075;SEVERIANO MELO;RN;61;18;79;227.848.101.265.822.000;772.151.898.734.177.000
2782;LIBERATO SALZANO;RS;78;23;101;227.722.772.277.227.000;772.277.227.722.772.000
8;ABATIµ;PR;112;33;145;227.586.206.896.551.000;772.413.793.103.448.000
1680;ENGENHO VELHO;RS;51;15;66;227.272.727.272.727.000;772.727.272.727.272.000
3150;MONTAURI;RS;51;15;66;227.272.727.272.727.000;772.727.272.727.272.000
4986;SEBASTI«O BARROS;PI;68;20;88;227.272.727.272.727.000;772.727.272.727.272.000
2100;IBERTIOGA;MG;109;32;141;226.950.354.609.929.000;773.049.645.390.070.000
2185;ILHOTA;SC;116;34;150;226.666.666.666.666.000;773.333.333.333.333.000
1697;ERVAL GRANDE;RS;58;17;75;226.666.666.666.666.000;773.333.333.333.333.000
710;BOM SUCESSO DO SUL;PR;58;17;75;226.666.666.666.666.000;773.333.333.333.333.000
1006;CAMUTANGA;PE;82;24;106;226.415.094.339.622.000;773.584.905.660.377.000
3645;PARNAMIRIM;PE;123;36;159;226.415.094.339.622.000;773.584.905.660.377.000
5246;TEREZINHA;PE;82;24;106;226.415.094.339.622.000;773.584.905.660.377.000
2694;LAGOA;PB;65;19;84;226.190.476.190.476.000;773.809.523.809.523.000
3528;PAI PEDRO;MG;89;26;115;226.086.956.521.739.000;773.913.043.478.260.000
1278;CHUVISCA;RS;89;26;115;226.086.956.521.739.000;773.913.043.478.260.000
3097;MIRACEMA DO TOCANTINS;TO;209;61;270;225.925.925.925.925.000;774.074.074.074.074.000
864;CACIMBA DE AREIA;PB;79;23;102;225.490.196.078.431.000;774.509.803.921.568.000
4768;S«O JORGE;RS;55;16;71;225.352.112.676.056.000;774.647.887.323.943.000
5544;VILA NOVA DO PIAU÷;PI;62;18;80;225.000.000.000.000.000;775.000.000.000.000.000
5512;VEREDINHA;MG;100;29;129;224.806.201.550.387.000;775.193.798.449.612.000
74;µGUAS MORNAS;SC;69;20;89;224.719.101.123.595.000;775.280.898.876.404.000
67;µGUAS DE CHAPEC‡;SC;76;22;98;224.489.795.918.367.000;775.510.204.081.632.000
554;BARRO ALTO;BA;76;22;98;224.489.795.918.367.000;775.510.204.081.632.000
3231;MULUNGU DO MORRO;BA;90;26;116;224.137.931.034.482.000;775.862.068.965.517.000
5059;SERRITA;PE;97;28;125;224.000.000.000.000.000;776.000.000.000.000.000
2991;MARMEL‡POLIS;MG;104;30;134;223.880.597.014.925.000;776.119.402.985.074.000
3606;PARAMIRIM;BA;104;30;134;223.880.597.014.925.000;776.119.402.985.074.000
1259;CHAPAD«O DO CêU;GO;104;30;134;223.880.597.014.925.000;776.119.402.985.074.000
3602;PARA÷SO DO SUL;RS;111;32;143;223.776.223.776.223.000;776.223.776.223.776.000
4512;SANTA TEREZA DO TOCANTINS;TO;66;19;85;223.529.411.764.705.000;776.470.588.235.294.000
5597;XAVANTINA;SC;66;19;85;223.529.411.764.705.000;776.470.588.235.294.000
44;AGRON‚MICA;SC;73;21;94;223.404.255.319.148.000;776.595.744.680.851.000
4484;SANTA RITA DE IBITIPOCA;MG;80;23;103;223.300.970.873.786.000;776.699.029.126.213.000
3315;NOVA AURORA;PR;80;23;103;223.300.970.873.786.000;776.699.029.126.213.000
2115;IBIPITANGA;BA;87;25;112;223.214.285.714.285.000;776.785.714.285.714.000
4646;S«O DOMINGOS;SE;94;27;121;223.140.495.867.768.000;776.859.504.132.231.000
4022;PRADO FERREIRA;PR;108;31;139;223.021.582.733.812.000;776.978.417.266.187.000
1873;FREI MIGUELINHO;PE;122;35;157;222.929.936.305.732.000;777.070.063.694.267.000
1942;GOIµS;GO;2288;654;2942;222.297.756.628.144.000;777.702.243.371.855.000
1266;CHARRUA;RS;49;14;63;222.222.222.222.222.000;777.777.777.777.777.000
62;µGUA SANTA;RS;63;18;81;222.222.222.222.222.000;777.777.777.777.777.000
714;BONFIM DO PIAU÷;PI;84;24;108;222.222.222.222.222.000;777.777.777.777.777.000
4515;SANTA TEREZINHA;PE;63;18;81;222.222.222.222.222.000;777.777.777.777.777.000
2763;LAURENTINO;SC;84;24;108;222.222.222.222.222.000;777.777.777.777.777.000
4758;S«O JO«O DO SUL;SC;63;18;81;222.222.222.222.222.000;777.777.777.777.777.000
4990;SEDE NOVA;RS;63;18;81;222.222.222.222.222.000;777.777.777.777.777.000
5525;VICENTE DUTRA;RS;77;22;99;222.222.222.222.222.000;777.777.777.777.777.000
5376;TURVO;PR;168;48;216;222.222.222.222.222.000;777.777.777.777.777.000
5127;SOUTO SOARES;BA;109;31;140;221.428.571.428.571.000;778.571.428.571.428.000
253;ANITA GARIBALDI;SC;88;25;113;221.238.938.053.097.000;778.761.061.946.902.000
5360;TUPANDI;RS;74;21;95;221.052.631.578.947.000;778.947.368.421.052.000
5330;TREZE DE MAIO;SC;74;21;95;221.052.631.578.947.000;778.947.368.421.052.000
1255;CHAPADA DE AREIA;TO;67;19;86;220.930.232.558.139.000;779.069.767.441.860.000
4055;PRESIDENTE NEREU;SC;67;19;86;220.930.232.558.139.000;779.069.767.441.860.000
2210;INDIAN‡POLIS;MG;127;36;163;220.858.895.705.521.000;779.141.104.294.478.000
3949;PONTE PRETA;RS;60;17;77;220.779.220.779.220.000;779.220.779.220.779.000
4767;S«O JOAQUIM DO MONTE;PE;166;47;213;220.657.276.995.305.000;779.342.723.004.694.000
1631;DOURADOQUARA;MG;99;28;127;220.472.440.944.881.000;779.527.559.055.118.000
25;ACORIZAL;MT;99;28;127;220.472.440.944.881.000;779.527.559.055.118.000
3828;PINHAL;RS;46;13;59;220.338.983.050.847.000;779.661.016.949.152.000
5576;VITORINO;PR;85;24;109;220.183.486.238.532.000;779.816.513.761.467.000
1820;FLOREST‡POLIS;PR;124;35;159;220.125.786.163.522.000;779.874.213.836.477.000
970;CAMPO BONITO;PR;110;31;141;219.858.156.028.368.000;780.141.843.971.631.000
390;AROAZES;PI;71;20;91;219.780.219.780.219.000;780.219.780.219.780.000
423;ATALANTA;SC;64;18;82;219.512.195.121.951.000;780.487.804.878.048.000
3906;PLANALTO ALEGRE;SC;64;18;82;219.512.195.121.951.000;780.487.804.878.048.000
90;ALAGOAS;AL;986;277;1263;219.319.081.551.860.000;780.680.918.448.139.000
1101;CARANA÷BA;MG;89;25;114;219.298.245.614.035.000;780.701.754.385.964.000
5286;TOCANTINS;TO;872;243;1115;217.937.219.730.941.000;782.062.780.269.058.000
4301;ROND‚NIA;RO;1216;338;1554;217.503.217.503.217.000;782.496.782.496.782.000
3860;PIRAJUBA;MG;90;25;115;217.391.304.347.826.000;782.608.695.652.173.000
3317;NOVA BASSANO;RS;72;20;92;217.391.304.347.826.000;782.608.695.652.173.000
607;BENJAMIN CONSTANT DO SUL;RS;54;15;69;217.391.304.347.826.000;782.608.695.652.173.000
4806;S«O JOSê DO HERVAL;RS;54;15;69;217.391.304.347.826.000;782.608.695.652.173.000
9;ABDON BATISTA;SC;65;18;83;216.867.469.879.518.000;783.132.530.120.481.000
4777;S«O JOSê DA LAGOA TAPADA;PB;76;21;97;216.494.845.360.824.000;783.505.154.639.175.000
718;BONITO;BA;105;29;134;216.417.910.447.761.000;783.582.089.552.238.000
2940;MARANH«O;MA;1696;468;2164;216.266.173.752.310.000;783.733.826.247.689.000
667;BODOC‡;PE;116;32;148;216.216.216.216.216.000;783.783.783.783.783.000
4071;PROGRESSO;RS;98;27;125;216.000.000.000.000.000;784.000.000.000.000.000
5020;SERGIPE;SE;629;173;802;215.710.723.192.019.000;784.289.276.807.980.000
5510;VER“;PR;80;22;102;215.686.274.509.803.000;784.313.725.490.196.000
1209;CAVALCANTE;GO;193;53;246;215.447.154.471.544.000;784.552.845.528.455.000
3471;OLIVEIRA FORTES;MG;102;28;130;215.384.615.384.615.000;784.615.384.615.384.000
5363;TUP«SSI;PR;113;31;144;215.277.777.777.777.000;784.722.222.222.222.000
4079;PUTINGA;RS;55;15;70;214.285.714.285.714.000;785.714.285.714.285.000
4342;SALGADO FILHO;PR;66;18;84;214.285.714.285.714.000;785.714.285.714.285.000
2358;ITAMBê DO MATO DENTRO;MG;99;27;126;214.285.714.285.714.000;785.714.285.714.285.000
1666;EMBU;SP;176;48;224;214.285.714.285.714.000;785.714.285.714.285.000
2142;ICARA÷ DE MINAS;MG;99;27;126;214.285.714.285.714.000;785.714.285.714.285.000
2104;IBIAM;SC;88;24;112;214.285.714.285.714.000;785.714.285.714.285.000
903;CAJAZEIRINHAS;PB;66;18;84;214.285.714.285.714.000;785.714.285.714.285.000
1952;GOUVEL∂NDIA;GO;92;25;117;213.675.213.675.213.000;786.324.786.324.786.000
5295;TORITAMA;PE;196;53;249;212.851.405.622.489.000;787.148.594.377.510.000
351;ARARIPINA;PE;237;64;301;212.624.584.717.607.000;787.375.415.282.392.000
779;BREJO DOS SANTOS;PB;63;17;80;212.500.000.000.000.000;787.500.000.000.000.000
3672;PATOS DO PIAU÷;PI;63;17;80;212.500.000.000.000.000;787.500.000.000.000.000
4537;SANTANA DO GARAMBêU;MG;89;24;113;212.389.380.530.973.000;787.610.619.469.026.000
3686;PAULA FREITAS;PR;115;31;146;212.328.767.123.287.000;787.671.232.876.712.000
3919;POÄO FUNDO;MG;119;32;151;211.920.529.801.324.000;788.079.470.198.675.000
5505;VERA CRUZ DO OESTE;PR;134;36;170;211.764.705.882.352.000;788.235.294.117.647.000
671;BOM CONSELHO;PE;175;47;222;211.711.711.711.711.000;788.288.288.288.288.000
5205;TAQUARITINGA DO NORTE;PE;108;29;137;211.678.832.116.788.000;788.321.167.883.211.000
951;CAMPINA DO SIM«O;PR;123;33;156;211.538.461.538.461.000;788.461.538.461.538.000
2737;LAJEADO DO BUGRE;RS;56;15;71;211.267.605.633.802.000;788.732.394.366.197.000
3282;NICOLAU VERGUEIRO;RS;56;15;71;211.267.605.633.802.000;788.732.394.366.197.000
4712;S«O JO«O;PE;112;30;142;211.267.605.633.802.000;788.732.394.366.197.000
4446;SANTA LÈCIA;PR;71;19;90;211.111.111.111.111.000;788.888.888.888.888.000
1079;CAPIT«O;RS;60;16;76;210.526.315.789.473.000;789.473.684.210.526.000
1487;CRUZALTENSE;RS;60;16;76;210.526.315.789.473.000;789.473.684.210.526.000
2333;ITAIPAVA DO GRAJAÈ;MA;154;41;195;210.256.410.256.410.000;789.743.589.743.589.000
4467;SANTA MARIA DO CAMBUCµ;PE;109;29;138;210.144.927.536.231.000;789.855.072.463.768.000
3720;PEDRA LAVRADA;PB;94;25;119;210.084.033.613.445.000;789.915.966.386.554.000
1796;FIGUEIR«O;MS;79;21;100;210.000.000.000.000.000;790.000.000.000.000.000
2481;JABOTICABA;RS;64;17;81;209.876.543.209.876.000;790.123.456.790.123.000
959;CAMPINAS DO SUL;RS;76;20;96;208.333.333.333.333.000;791.666.666.666.666.000
4895;S«O PEDRO DAS MISSÂES;RS;57;15;72;208.333.333.333.333.000;791.666.666.666.666.000
1714;ESP÷RITO SANTO;ES;1437;376;1813;207.391.064.533.921.000;792.608.935.466.078.000
1299;COCAL DOS ALVES;PI;65;17;82;207.317.073.170.731.000;792.682.926.829.268.000
4609;SANTO INµCIO DO PIAU÷;PI;65;17;82;207.317.073.170.731.000;792.682.926.829.268.000
2354;ITAMBARACµ;PR;127;33;160;206.250.000.000.000.000;793.750.000.000.000.000
4948;S«O VALêRIO DO SUL;RS;54;14;68;205.882.352.941.176.000;794.117.647.058.823.000
868;CACIQUE DOBLE;RS;66;17;83;204.819.277.108.433.000;795.180.722.891.566.000
3384;NOVA PRATA DO IGUAÄU;PR;82;21;103;203.883.495.145.631.000;796.116.504.854.368.000
4074;PROTµSIO ALVES;RS;51;13;64;203.125.000.000.000.000;796.875.000.000.000.000
1559;DEZESSEIS DE NOVEMBRO;RS;59;15;74;202.702.702.702.702.000;797.297.297.297.297.000
3871;PIRAP‡;RS;67;17;84;202.380.952.380.952.000;797.619.047.619.047.000
1774;FEIRA NOVA DO MARANH«O;MA;80;20;100;200.000.000.000.000.000;800.000.000.000.000.000
3087;MINAS GERAIS;MG;4230;1046;5276;198.256.254.738.438.000;801.743.745.261.561.000
750;BRAGANEY;PR;130;32;162;197.530.864.197.530.000;802.469.135.802.469.000
457;BAHIA;BA;2334;574;2908;197.386.519.944.979.000;802.613.480.055.020.000
2980;MARILUZ;PR;136;33;169;195.266.272.189.349.000;804.733.727.810.650.000
4813;S«O JOSê DO OURO;RS;59;14;73;191.780.821.917.808.000;808.219.178.082.191.000
4286;RODELAS;BA;89;21;110;190.909.090.909.090.000;809.090.909.090.909.000
3776;PERNAMBUCO;PE;1778;417;2195;189.977.220.956.719.000;810.022.779.043.280.000
4784;S«O JOSê DAS MISSÂES;RS;52;12;64;187.500.000.000.000.000;812.500.000.000.000.000
3113;MIRASELVA;PR;61;14;75;186.666.666.666.666.000;813.333.333.333.333.000
650;BOA VISTA DAS MISSÂES;RS;57;13;70;185.714.285.714.285.000;814.285.714.285.714.000
877;CAETêS;PE;102;23;125;184.000.000.000.000.000;816.000.000.000.000.000
1485;CRUZ MACHADO;PR;142;32;174;183.908.045.977.011.000;816.091.954.022.988.000
2566;JATAÈBA;PE;95;21;116;181.034.482.758.620.000;818.965.517.241.379.000
3377;NOVA PµDUA;RS;65;14;79;177.215.189.873.417.000;822.784.810.126.582.000
1091;CAPOEIRAS;PE;130;28;158;177.215.189.873.417.000;822.784.810.126.582.000
880;CAFEARA;PR;64;13;77;168.831.168.831.168.000;831.168.831.168.831.000
2833;LUPION‡POLIS;PR;99;17;116;146.551.724.137.931.000;853.448.275.862.068.000
2380;ITAPEJARA D'OESTE;PR;82;14;96;145.833.333.333.333.000;854.166.666.666.666.000
4555;SANTARêM;PB;19;3;22;136.363.636.363.636.000;863.636.363.636.363.000
3626;PARATI;RJ;97;15;112;133.928.571.428.571.000;866.071.428.571.428.000
5589;WESTFALIA;RS;20;3;23;130.434.782.608.695.000;869.565.217.391.304.000
971;CAMPO DE SANTANA;PB;28;4;32;125.000.000.000.000.000;875.000.000.000.000.000
2369;ITA‡CA;SP;31;3;34;88.235.294.117.647.000;911.764.705.882.352.000
